,domain,nb_item,nb_item_search,nb_item_bought,413163,
1561,MLB-CELLPHONES,38390,369039,25070,25070,6%
1531,MLB-SNEAKERS,32636,181450,14608,39678,10%
2035,MLB-SUPPLEMENTS,22351,75792,9562,49240,12%
1752,MLB-HEADPHONES,11328,71895,9053,58293,14%
1597,MLB-SMARTWATCHES,8721,81975,7963,66256,16%
2003,MLB-DOLLS,10023,68197,4915,71171,17%
1869,MLB-VIDEO_GAMES,12742,34612,4637,75808,18%
28,MLM-HEADPHONES,5731,49219,4603,80411,19%
2173,MLB-BOOTS_AND_BOOTIES,8564,42622,4325,84736,21%
2429,MLB-STREAMING_MEDIA_DEVICES,4807,29602,4104,88840,22%
1573,MLB-T_SHIRTS,23823,68935,3746,92586,22%
2052,MLB-PANTS,10309,53829,3443,96029,23%
2961,MLB-SURVEILLANCE_CAMERAS,4365,24579,3443,99472,24%
1596,MLB-HAIR_TREATMENTS,13529,39269,3405,102877,25%
1594,MLB-CELLPHONE_SCREENS,6595,19368,3047,105924,26%
1962,MLB-WALL_AND_CEILING_LIGHTS,9144,35088,2970,108894,26%
2012,MLB-SHORTS,8472,48460,2856,111750,27%
2361,MLB-HARD_DRIVES_AND_SSDS,3146,12368,2843,114593,28%
1564,MLB-SPEAKERS,7082,35213,2774,117367,28%
6,MLM-CELLPHONE_COVERS,7475,28035,2698,120065,29%
1601,MLB-SANDALS_AND_FLIP_FLOPS,15102,51639,2600,122665,30%
1750,MLB-WRISTWATCHES,13136,45550,2561,125226,30%
1891,MLB-DRESSES,21590,84907,2536,127762,31%
2561,MLB-MICROWAVES,1917,19103,2442,130204,32%
2725,MLB-GEL_NAIL_KITS,2566,27771,2294,132498,32%
2268,MLB-FANS,2884,17334,2201,134699,33%
2002,MLB-HAIR_CLIPPERS,3555,14233,2160,136859,33%
1538,MLB-ACTION_FIGURES,13597,30262,2106,138965,34%
2553,MLB-MALE_UNDERWEAR,2925,15717,2069,141034,34%
2372,MLB-FLEA_AND_TICK_TREATMENTS,1866,7536,2050,143084,35%
3449,MLB-CARD_PAYMENT_TERMINALS,979,10622,2017,145101,35%
47,MLM-CELLPHONES,8035,40460,1947,147048,36%
1759,MLB-FOOTBALL_SHIRTS,6801,22632,1933,148981,36%
2832,MLB-BODY_SHAPERS,2426,13996,1836,150817,37%
1843,MLB-BACKPACKS,8934,26530,1812,152629,37%
1543,MLB-INDOOR_CURTAINS_AND_BLINDS,5329,24131,1800,154429,37%
2776,MLB-TELEVISIONS,3270,27798,1779,156208,38%
2030,MLB-UNCLASSIFIED_PRODUCTS,6287,11320,1720,157928,38%
1581,MLB-LOAFERS_AND_OXFORDS,3157,15690,1681,159609,39%
40,MLM-SMARTWATCHES,2199,17945,1643,161252,39%
1542,MLB-TOYS_AND_GAMES,9391,25448,1640,162892,39%
1778,MLB-VIDEO_GAME_PREPAID_CARDS,985,4483,1627,164519,40%
1753,MLB-MOTORCYCLE_HELMETS,5691,24657,1521,166040,40%
2743,MLB-CELLPHONE_ACCESSORIES,3177,12519,1514,167554,41%
1893,MLB-VEHICLE_ACCESSORIES,28986,43932,1511,169065,41%
2979,MLB-VEHICLE_STEREOS,2541,14041,1510,170575,41%
4348,MLB-PUZZLE_CUBES,1199,7736,1504,172079,42%
2042,MLB-SUNGLASSES,6077,19144,1413,173492,42%
2212,MLB-HOME_APPLIANCES_ACCESSORIES_AND_SPARE_PARTS,7637,11894,1381,174873,42%
2011,MLB-CELLPHONE_COVERS,11177,26958,1379,176252,43%
1842,MLB-GAMEPADS_AND_JOYSTICKS,2765,9966,1375,177627,43%
2447,MLB-DIAPER_BAGS,1933,15528,1346,178973,43%
2124,MLB-SCOOTERS,2030,13761,1333,180306,44%
3541,MLB-TEETH_WHITENING_PRODUCTS,1020,5398,1269,181575,44%
1959,MLB-FOOTBALL_SHOES,4141,15688,1233,182808,44%
2393,MLB-CELLPHONE_BATTERIES,2092,5693,1231,184039,45%
2395,MLB-PORTABLE_CELLPHONE_CHARGERS,1358,8035,1231,185270,45%
1562,MLB-SOUVENIRS,11017,22896,1219,186489,45%
1896,MLB-FLOOD_LIGHTS,2089,8300,1185,187674,45%
2307,MLB-WOMEN_SWIMWEAR,6090,27697,1171,188845,46%
2826,MLB-AUTOMOTIVE_AMPLIFIERS,3448,12555,1165,190010,46%
1595,MLB-PRINTERS,2805,10370,1160,191170,46%
1568,MLB-DRILLS_SCREWDRIVERS,1824,12828,1140,192310,47%
2888,MLB-AIR_CONDITIONERS,2410,13281,1116,193426,47%
2273,MLB-COOKING_SCALES,554,3624,1068,194494,47%
2317,MLB-PERFUMES,8393,17822,1046,195540,47%
1970,MLB-WRENCH_SETS,2313,12203,1044,196584,48%
2896,MLB-PORTABLE_ELECTRIC_MASSAGERS,1337,5798,1039,197623,48%
327,MLM-CELLPHONE_SCREENS,2215,6153,1019,198642,48%
2211,MLB-NON_CORRECTIVE_CONTACT_LENSES,1119,8993,1011,199653,48%
1540,MLB-BOOKS,9973,15842,1006,200659,49%
2112,MLB-FACIAL_SKIN_CARE_PRODUCTS,4479,11913,1005,201664,49%
2043,MLB-GAME_CONSOLES,5541,19877,999,202663,49%
2180,MLB-COSTUMES,6015,16223,977,203640,49%
2081,MLB-SWEATSHIRTS_AND_HOODIES,6944,19723,972,204612,50%
2164,MLB-ROUTERS_AND_WIRELESS_SYSTEMS,2114,7444,968,205580,50%
2339,MLB-LIGHT_BULBS,2603,6916,957,206537,50%
2027,MLB-HANDBAGS,6539,20848,951,207488,50%
2107,MLB-PRINTER_INKS,1311,4016,927,208415,50%
2514,MLB-CARPETS,3853,14621,925,209340,51%
2904,MLB-PAINT_SPRAYERS,1417,6420,911,210251,51%
2368,MLB-BODY_SKIN_CARE_PRODUCTS,5749,12717,906,211157,51%
19,MLM-WRISTWATCHES,4492,13624,879,212036,51%
3086,MLB-VOLTAGE_CONVERTERS,764,4577,876,212912,52%
2373,MLB-BLOOD_PRESSURE_MONITORS,534,2923,858,213770,52%
516,MLM-VIDEO_GAME_PREPAID_CARDS,479,1539,855,214625,52%
209,MLM-PARTY_MASKS,1914,8474,853,215478,52%
3252,MLB-MEMORY_CARDS,1302,4526,852,216330,52%
2469,MLB-BEAUTY_AND_PERSONAL_CARE_SUPPLIES,3105,6707,842,217172,53%
1967,MLB-ELECTRIC_PRESSURE_WASHERS,877,6581,829,218001,53%
3035,MLB-HAIR_STRAIGHTENERS,1712,7420,815,218816,53%
2115,MLB-CONTINUOUS_LIGHTING,873,6270,807,219623,53%
2486,MLB-BABY_SUPPLIES,4360,11575,802,220425,53%
2656,MLB-TABLETS,2565,11191,787,221212,54%
1995,MLB-AIRSOFT_GUNS,4015,18033,786,221998,54%
2634,MLB-KITCHEN_FAUCETS,1360,5673,784,222782,54%
2379,MLB-OFFICE_SOFTWARE,850,1505,782,223564,54%
2666,MLB-MICROPHONES,2448,7796,782,224346,54%
3706,MLB-BODYWEIGHT_SCALES,526,3395,781,225127,54%
422,MLM-CATS_AND_DOGS_FOODS,815,2446,772,225899,55%
2053,MLB-BICYCLES,6631,28418,771,226670,55%
3894,MLB-OPERATING_SYSTEMS,488,1004,769,227439,55%
1762,MLB-PANTIES,3094,14148,767,228206,55%
3057,MLB-LED_STRIPS,1397,5697,753,228959,55%
2560,MLB-AUDIO_AND_VIDEO_CABLES_AND_ADAPTERS,3966,7921,750,229709,56%
125,MLM-CELLPHONE_ACCESSORIES,1720,7626,731,230440,56%
1846,MLB-JUMPSUITS_AND_OVERALLS,5661,20847,728,231168,56%
2356,MLB-HOME_SUPPLIES,6293,13050,726,231894,56%
2416,MLB-MAKEUP_TRAIN_CASES,1061,11622,721,232615,56%
2895,MLB-HOVERBOARDS,802,7659,721,233336,56%
1774,MLB-JACKETS_AND_COATS,4930,15416,717,234053,57%
2346,MLB-ROUTERS,1232,4144,717,234770,57%
312,MLM-HARD_DRIVES_AND_SSDS,861,3450,716,235486,57%
2376,MLB-BABIES_FOOTWEAR,2372,9479,715,236201,57%
87,MLM-JACKETS_AND_COATS,2940,11529,712,236913,57%
2734,MLB-KITCHEN_COOKWARE_SETS,2028,10429,708,237621,58%
2874,MLB-BLENDERS,1126,4618,706,238327,58%
120,MLM-BACKPACKS,2665,9981,696,239023,58%
1991,MLB-WATER_PURIFIERS_FILTERS,1566,6691,696,239719,58%
3053,MLB-BEARD_OILS_AND_BALMS,880,3178,693,240412,58%
29,MLM-SWEATSHIRTS_AND_HOODIES,3071,10398,692,241104,58%
72,MLM-COSTUMES,4602,10495,689,241793,59%
1777,MLB-STUFFED_TOYS,3848,9394,670,242463,59%
3428,MLB-SOFA_AND_FUTON_COVERS,1288,5995,664,243127,59%
1578,MLB-RAM_MEMORY_MODULES,1808,4606,653,243780,59%
1,MLM-VIDEO_GAMES,2892,5504,652,244432,59%
2119,MLB-ROLLER_SKATES,1489,8306,650,245082,59%
2055,MLB-DESIGN_AND_MULTIMEDIA_SOFTWARE,1442,2430,646,245728,59%
2225,MLB-BLOUSES,6730,20857,633,246361,60%
2678,MLB-MOBILE_DEVICE_CHARGERS,1603,4476,625,246986,60%
2114,MLB-SKIRTS,4173,16139,623,247609,60%
2162,MLB-VACUUM_CLEANERS,1184,4789,618,248227,60%
2910,MLB-SKIN_CARE_SUPPLIES,2111,5378,616,248843,60%
2443,MLB-WELDING_MACHINES,1346,8288,612,249455,60%
2770,MLB-POWER_GRINDERS,855,4867,601,250056,61%
2517,MLB-HATS_AND_CAPS,5567,13145,597,250653,61%
1563,MLB-FOG_LIGHTS,3562,7442,593,251246,61%
2025,MLB-VEHICLE_MULTIMEDIA_SYSTEMS,4201,12286,592,251838,61%
2639,MLB-VEGETABLES_AND_FRUITS_CHOPPERS,893,3594,583,252421,61%
2479,MLB-NECKLACES,6371,14597,580,253001,61%
2525,MLB-KEYBOARD_AND_MOUSE_KITS,1099,4654,580,253581,61%
2365,MLB-LINGERIE_SETS,2027,9852,579,254160,62%
2408,MLB-NAIL_DRYERS,841,5257,579,254739,62%
3183,MLB-AUTOMOTIVE_CELLPHONE_AND_GPS_MOUNTS,1216,4111,576,255315,62%
2077,MLB-HAIR_EXTENSIONS,2938,10280,571,255886,62%
2118,MLB-WALLETS,2347,8319,567,256453,62%
2671,MLB-BRAS,1710,6839,567,257020,62%
2313,MLB-MAKEUP_BRUSHES,1256,6978,558,257578,62%
409,MLM-MEMORY_CARDS,539,3423,555,258133,62%
2041,MLB-COMPUTER_EQUIPMENT_AND_SPARE_PARTS,6307,8911,541,258674,63%
1996,MLB-ARTS_AND_CRAFTS,9085,14208,540,259214,63%
1799,MLB-KITCHEN_SUPPLIES,9308,15586,538,259752,63%
1779,MLB-TOOL_ACCESSORIES_AND_SPARES,7682,11942,535,260287,63%
1755,MLB-ELECTRONIC_PRODUCTS,6544,10627,532,260819,63%
3647,MLB-VEHICLE_BATTERY_CHARGERS,830,3065,528,261347,63%
2857,MLB-ORTHOPEDICS,722,2896,525,261872,63%
3841,MLB-AUDIO_AND_VIDEO_CONVERTERS,723,2677,524,262396,64%
2228,MLB-SEWING_MACHINES,1201,5278,523,262919,64%
2229,MLB-FLASHLIGHTS,1477,4847,522,263441,64%
2015,MLB-AUTOMOTIVE_HEADLIGHTS,4039,7742,521,263962,64%
2345,MLB-TV_AND_MONITOR_MOUNTS,1049,4138,518,264480,64%
2403,MLB-PORTABLE_EVAPORATIVE_AIR_COOLERS,930,6169,518,264998,64%
1559,MLB-CAR_SEAT_COVERS,4403,9351,516,265514,64%
3030,MLB-BABY_CLOTHING,1541,8283,516,266030,64%
233,MLM-BODY_SHAPERS,1147,4631,513,266543,65%
101,MLM-VEHICLE_STEREOS,657,4478,508,267051,65%
1574,MLB-VEHICLE_LED_BULBS,3495,8396,506,267557,65%
3229,MLB-CLEANING_MOPS,934,4256,505,268062,65%
1754,MLB-CELLPHONE_TABLET_AND_GPS_SCREEN_PROTECTORS,2428,5386,499,268561,65%
590,MLM-CELLPHONE_BATTERIES,622,2116,495,269056,65%
1958,MLB-SHIRTS,4950,14832,495,269551,65%
4022,MLB-WALKIE_TALKIES,690,2458,489,270040,65%
1365,MLM-COOKING_SCALES,209,1907,487,270527,65%
1895,MLB-FLATS,2874,9889,483,271010,66%
2606,MLB-HOME_APPLIANCES,2489,5533,482,271492,66%
1952,MLB-GARDEN_HOSES,828,2821,474,271966,66%
2669,MLB-BIRD_EGGS_INCUBATORS,374,3887,470,272436,66%
3196,MLB-MOTORCYCLE_RAIN_SUITS,964,4472,469,272905,66%
2209,MLB-TABLE_AND_DESK_LAMPS,2161,5698,457,273362,66%
2098,MLB-TOOLS,7151,11712,455,273817,66%
2674,MLB-SUITS,1606,7076,452,274269,66%
2876,MLB-WEDDING_BANDS,1952,8927,450,274719,66%
2780,MLB-GATE_MOTORS,875,3722,447,275166,67%
2824,MLB-MOTORCYCLE_REARVIEW_MIRRORS,987,3168,446,275612,67%
2099,MLB-GARDEN_AND_OUTDOOR_SUPPLIES,2646,5770,442,276054,67%
202,MLM-SUPPLEMENTS,1760,4099,438,276492,67%
3842,MLB-MICRONEEDLE_ROLLERS,379,2009,435,276927,67%
281,MLM-AUDIO_AND_VIDEO_CABLES_AND_ADAPTERS,1235,3104,431,277358,67%
2991,MLB-WIRELESS_FM_TRANSMITTERS,1073,3032,426,277784,67%
2026,MLB-BRACELETS_AND_ANKLE_BRACES,2771,7070,424,278208,67%
1758,MLB-PARTY_SUPPLIES,6842,12633,421,278629,67%
2846,MLB-AUTOMOTIVE_IGNITION_KEYS,1695,3936,421,279050,68%
3256,MLB-MARTIAL_ARTS_AND_BOXING_GLOVES,754,4000,421,279471,68%
3203,MLB-FOODS_AND_DRINKS,2311,3455,415,279886,68%
243,MLM-SUNGLASSES,1423,4412,411,280297,68%
44,MLM-SNEAKERS,9824,18320,408,280705,68%
2156,MLB-DECORATIVE_PAINTINGS,6454,14191,404,281109,68%
1565,MLB-TV_STORAGE_UNITS,1922,10981,402,281511,68%
21,MLM-DATA_CABLES_AND_ADAPTERS,1295,3737,401,281912,68%
2095,MLB-ELECTRIC_CIRCULAR_SAWS,915,3963,400,282312,68%
1963,MLB-KIDS_TENTS,626,3851,399,282711,68%
3552,MLB-HAIR_DRYERS,1314,3871,399,283110,69%
2105,MLB-AUTOMOTIVE_TIRES,4657,11823,397,283507,69%
3056,MLB-SPORT_WATCHES,1559,5002,396,283903,69%
247,MLM-SURVEILLANCE_CAMERAS,948,4238,392,284295,69%
2357,MLB-DRYING_RACKS,766,2874,391,284686,69%
2457,MLB-REMOTE_CONTROL_TOY_VEHICLES,1655,6038,390,285076,69%
2650,MLB-DRILL_BITS,1588,4512,389,285465,69%
3855,MLB-CAMERA_TRIPODS,621,2495,389,285854,69%
1558,MLB-VEHICLE_PARTS,18727,23433,387,286241,69%
2369,MLB-CRAFT_MOLDS,1429,4791,386,286627,69%
5050,MLB-INFRARED_THERMOMETERS,192,1279,386,287013,69%
3105,MLB-HEALTH_CARE_SUPPLIES,1665,3864,385,287398,70%
2493,MLB-COFFEE_CAPSULES,567,1788,382,287780,70%
3426,MLB-CHRISTMAS_LIGHTS,1108,3835,382,288162,70%
321,MLM-SPEAKERS,2212,6154,381,288543,70%
2452,MLB-TRADING_CARD_GAMES,1598,3879,381,288924,70%
2563,MLB-COMPUTER_MICE,1267,3024,377,289301,70%
3357,MLB-OFFICE_CHAIRS,1210,4961,377,289678,70%
3578,MLB-DEEP_FRYERS,1164,4809,376,290054,70%
4128,MLB-INDUSTRIAL_MAGNETS,315,1335,376,290430,70%
2100,MLB-INFLATABLE_POOLS,903,4422,375,290805,70%
3266,MLB-BABY_PUZZLE_PLAY_MATS,620,3486,373,291178,70%
2083,MLB-CRIB_BEDDING_SETS,1383,6822,371,291549,71%
3369,MLB-UKULELES,502,2268,371,291920,71%
2360,MLB-ELECTRONIC_ACCESSORIES_AND_SPARE_PARTS,5340,8542,369,292289,71%
3848,MLB-KITCHEN_PLAYSETS,841,4691,368,292657,71%
4394,MLB-HARD_DRIVE_AND_SSD_ENCLOSURES,421,1447,365,293022,71%
1844,MLB-ANIMAL_AND_PET_PRODUCTS,3180,5506,359,293381,71%
39,MLM-NON_CORRECTIVE_CONTACT_LENSES,556,2911,355,293736,71%
2544,MLB-SOCKS,1549,3595,355,294091,71%
4007,MLB-ELECTRIC_FACIAL_BRUSHES_AND_SPONGES,404,2104,355,294446,71%
2449,MLB-HUMIDIFIERS_AND_VAPORIZERS,608,2695,352,294798,71%
2165,MLB-CLOTHES_HANGERS,833,2767,349,295147,71%
1585,MLM-INDUSTRIAL_AND_COMMERCIAL_SCALES,198,1309,348,295495,72%
2316,MLB-GAME_CONSOLES_VIDEO_GAMES_AND_ARCADE_MACHINES,4152,7234,347,295842,72%
2700,MLB-DISPOSABLE_CUPS,1284,4864,347,296189,72%
102,MLM-BOOKS,2437,3966,339,296528,72%
2709,MLB-DATA_CABLES_AND_ADAPTERS,1949,3919,339,296867,72%
2902,MLB-ELECTRIC_DRILLS,795,3295,339,297206,72%
1800,MLB-LAPTOP_CHARGERS,983,1771,336,297542,72%
99,MLM-COMPUTER_EQUIPMENT_AND_SPARE_PARTS,2467,4017,334,297876,72%
248,MLM-CAR_LIGHT_BULBS,1305,4370,334,298210,72%
105,MLM-HAIR_TREATMENTS,546,1951,333,298543,72%
219,MLM-LAPTOP_CHARGERS,494,1354,331,298874,72%
4462,MLB-MANUAL_DRINKING_WATER_PUMPS,214,1025,329,299203,72%
16,MLM-UNCLASSIFIED_PRODUCTS,2913,4391,325,299528,72%
336,MLM-PENDRIVES,741,2210,322,299850,73%
2213,MLB-SCHOOL_AND_OFFICE_PAPERS,1921,3902,322,300172,73%
2480,MLB-FOOTWEAR,1486,3399,318,300490,73%
3727,MLB-LASER_MEASURES,279,1375,316,300806,73%
3388,MLB-HOOKAHS,1025,5133,312,301118,73%
4164,MLB-HAIR_BRUSHES,858,3082,312,301430,73%
94,MLM-STREAMING_MEDIA_DEVICES,656,2805,311,301741,73%
3620,MLB-SUITCASES,1201,5728,311,302052,73%
2827,MLB-LEGGINGS,2354,7706,308,302360,73%
3383,MLB-FALSE_EYELASHES,1601,4294,307,302667,73%
2960,MLB-CELL_BATTERIES,1039,1908,304,302971,73%
2084,MLB-AUTOMOTIVE_SPEAKERS,5266,12812,303,303274,73%
2516,MLB-GLASSES_FRAMES,2376,6557,302,303576,73%
2172,MLB-CHINESE_MEDICAL_CUPS_SETS,256,1709,299,303875,74%
2618,MLB-INK_CARTRIDGES,1121,2128,298,304173,74%
2875,MLB-WASHING_MACHINES,1433,6695,296,304469,74%
7101,MLB-PRINTER_SOFTWARE,92,198,295,304764,74%
3447,MLB-ANIMAL_CLIPPERS,446,1974,294,305058,74%
2102,MLB-HAIR_SHAMPOOS_AND_CONDITIONERS,3451,7038,293,305351,74%
4734,MLB-WELDING_MASKS,413,1737,293,305644,74%
3668,MLB-AB_ROLLER_WHEELS,320,1578,291,305935,74%
2605,MLB-HAIRDRESSING_ACCESSORIES,986,2040,288,306223,74%
2350,MLB-SHOWER_HEADS,1377,3493,287,306510,74%
4361,MLB-ORTHOTICS,463,1594,286,306796,74%
2566,MLB-VEHICLE_CAMERAS,903,2858,285,307081,74%
4092,MLB-HAIRDRESSING_SCISSORS,587,2784,284,307365,74%
187,MLM-BODY_SKIN_CARE_PRODUCTS,710,2083,283,307648,74%
146,MLM-MARKERS_AND_HIGHLIGHTERS,378,2013,280,307928,75%
299,MLM-DOOR_AND_WINDOW_AWNINGS_AND_EAVES,279,1721,279,308207,75%
88,MLM-MOBILE_DEVICE_CHARGERS,856,2501,276,308483,75%
1576,MLB-PENDRIVES,1115,2513,276,308759,75%
2037,MLB-COOKTOPS,774,4154,276,309035,75%
3108,MLB-GIFT_CARDS,257,687,275,309310,75%
3863,MLB-INDUSTRIAL_AND_COMMERCIAL_SCALES,395,1686,275,309585,75%
3119,MLB-CARS_AND_VANS_COVERS,1242,2314,274,309859,75%
3130,MLB-PC_KEYBOARDS,1287,3640,274,310133,75%
4399,MLB-DISPOSABLE_BABY_DIAPERS,1191,3087,274,310407,75%
2659,MLB-NAIL_STICKERS,804,4256,272,310679,75%
663,MLM-SHOE_RACKS,293,1591,271,310950,75%
1773,MLB-RESISTANCE_BANDS,595,2079,271,311221,75%
93,MLM-PORTABLE_CELLPHONE_CHARGERS,483,2267,266,311487,75%
3609,MLB-ELECTRIC_SQUEEZERS,309,1593,266,311753,75%
2878,MLB-INDUSTRIAL_AND_COMMERCIAL_BAG_SEALERS,442,1308,265,312018,76%
168,MLM-T_SHIRTS,4307,7905,263,312281,76%
3470,MLB-HAMMER_DRILLS,707,3581,262,312543,76%
200,MLM-PRINTER_INKS,336,1165,261,312804,76%
709,MLM-LED_STRIPS,515,2323,260,313064,76%
3723,MLB-WATER_DISPENSERS,568,2798,260,313324,76%
2755,MLB-KIDS_TRICYCLES,727,3645,259,313583,76%
3344,MLB-CHRISTMAS_TREE_ORNAMENTS,652,2623,258,313841,76%
1998,MLB-DECORATIVE_VINYLS,4230,11134,257,314098,76%
2711,MLB-CLOTHING_LOTS,1610,5962,256,314354,76%
2344,MLB-INDUSTRIAL_AND_COMMERCIAL_EQUIPMENT,10252,15209,255,314609,76%
1532,MLB-TV_REPLACEMENT_BACKLIGHT_LED_STRIPS,937,1602,253,314862,76%
2565,MLB-LED_STAGE_LIGHTS,1271,3476,251,315113,76%
193,MLM-HANDBAGS,1456,4759,250,315363,76%
164,MLM-MAKEUP_BRUSHES,490,3102,249,315612,76%
265,MLM-PERFUMES,1899,3283,249,315861,76%
1965,MLB-COOKING_OILS,351,1005,249,316110,77%
2627,MLB-NEBULIZERS,508,1724,249,316359,77%
153,MLM-WALLETS,1456,4264,245,316604,77%
313,MLM-PRINTERS,940,3108,245,316849,77%
36,MLM-DRESSES,3391,7794,242,317091,77%
2628,MLB-COMPUTER_MONITORS,1319,3588,242,317333,77%
2885,MLB-MAKEUP_SETS,1007,4757,241,317574,77%
4358,MLB-KNEE_BRACES_SUPPORTS,419,1614,241,317815,77%
169,MLM-ROUTERS_AND_WIRELESS_SYSTEMS,432,1617,239,318054,77%
2396,MLB-BABY_ACTIVITY_CENTERS,878,2932,239,318293,77%
2788,MLB-MANUAL_AIR_PUMPS,400,1521,238,318531,77%
4497,MLB-MATTRESS_COVERS,459,1355,237,318768,77%
2637,MLB-CAR_SCANNERS,794,2132,236,319004,77%
1569,MLB-NAIL_FILES,821,3294,235,319239,77%
1994,MLB-NOTEBOOKS,4031,12861,235,319474,77%
4479,MLB-OXIMETERS,209,1078,235,319709,77%
239,MLM-CELLPHONE_TABLET_AND_GPS_SCREEN_PROTECTORS,1038,2842,234,319943,77%
3433,MLB-ELECTRIC_LUNCHBOXES,293,1356,234,320177,77%
4052,MLB-MULTIMETERS,663,1882,234,320411,78%
14,MLM-BEAUTY_AND_PERSONAL_CARE_SUPPLIES,1382,2421,233,320644,78%
2924,MLB-TENTS,996,3354,233,320877,78%
4146,MLB-MARTIAL_ARTS_UNIFORMS,612,2033,233,321110,78%
3721,MLB-VR_HEADSETS,353,1464,232,321342,78%
2645,MLB-THERMAL_REFRIGERATORS_AND_BAGS,1522,4367,231,321573,78%
2470,MLB-CAR_LIGHT_BULBS,2481,4451,230,321803,78%
3118,MLB-WRENCHES,916,3009,230,322033,78%
2442,MLB-REFRIGERATORS,2294,10842,229,322262,78%
3537,MLB-BABY_CRIBS_AND_BASSINETS,401,1738,229,322491,78%
2245,MLB-CAT_AND_DOG_DRINKERS_AND_FEEDERS,743,2091,228,322719,78%
128,MLM-NECKLACES,1859,4441,227,322946,78%
3020,MLB-BICYCLE_ACCESSORIES_AND_SPARE_PARTS,2346,4418,226,323172,78%
3353,MLB-DOLLHOUSES,639,3243,226,323398,78%
346,MLM-HAIR_SHAMPOOS_AND_CONDITIONERS,518,1436,225,323623,78%
2648,MLB-EMBEDDED_SWITCH_MODE_POWER_SUPPLIES,394,1280,225,323848,78%
3155,MLB-TOY_DRUMS,425,1985,224,324072,78%
197,MLM-INDUSTRIAL_AND_COMMERCIAL_EQUIPMENT,2171,2742,222,324294,78%
329,MLM-FLASHLIGHTS,389,1669,221,324515,79%
419,MLM-BRACELETS_AND_ANKLE_BRACES,1448,3533,221,324736,79%
2404,MLB-THERMOSES,1215,3269,219,324955,79%
3018,MLB-PUNCHING_BAGS,257,1498,219,325174,79%
400,MLM-FACIAL_SKIN_CARE_PRODUCTS,1244,2898,218,325392,79%
5143,MLB-ORTHODONTIC_BRACKETS,255,1255,218,325610,79%
2474,MLB-EPILATORS_AND_TRIMMERS,484,1729,216,325826,79%
3446,MLB-FOUNDATIONS,1231,3063,216,326042,79%
3591,MLB-LASER_LEVELS,421,1917,216,326258,79%
64,MLM-SUITCASES,529,2797,215,326473,79%
3612,MLB-DIMMERS,729,1948,214,326687,79%
4076,MLB-FOOD_PROCESSORS,372,1971,214,326901,79%
213,MLM-AESTHETIC_TREATMENT_TABLES_AND_CHAIRS,193,1638,213,327114,79%
4021,MLB-AIR_CONDITIONER_REMOTE_CONTROLS,521,908,212,327326,79%
3361,MLB-ELECTRIC_GRILLS,549,2271,211,327537,79%
5310,MLB-LADDERS,626,2832,211,327748,79%
2804,MLB-SAFES,449,1791,210,327958,79%
3580,MLB-GAZEBOS,458,2282,209,328167,79%
2006,MLB-CLOTHING,3468,6585,208,328375,79%
3621,MLB-XENON_KITS,518,1683,208,328583,80%
1849,MLB-DIECAST_VEHICLES,4911,8564,206,328789,80%
2433,MLB-EARRINGS,2130,4693,205,328994,80%
2602,MLB-HAMMOCKS,444,1894,205,329199,80%
4194,MLB-FRAME_POOLS,465,2861,205,329404,80%
1955,MLB-AUTOMOTIVE_STEERING_WHEELS,2310,4366,203,329607,80%
2111,MLB-FASHION_ACCESSORIES,1596,3160,203,329810,80%
2868,MLB-TELEPHONES,592,1149,203,330013,80%
2314,MLB-HEELS_AND_WEDGES,1849,5465,202,330215,80%
2722,MLB-PARTY_MASKS,1271,3015,202,330417,80%
144,MLM-BODYWEIGHT_SCALES,194,846,201,330618,80%
2803,MLB-DOOR_AND_STAIR_SAFETY_FENCES,307,1178,201,330819,80%
3643,MLB-HYDRAULIC_VEHICLE_JACKS,429,1470,201,331020,80%
4441,MLB-BATTERY_CHARGERS,361,966,201,331221,80%
121,MLM-MICROCONTROLLER_BOARDS,1331,2759,200,331421,80%
2335,MLB-MANICURE_AND_PEDICURE_SUPPLIES,1112,3482,200,331621,80%
3073,MLB-KITCHEN_BAKING_DISHES_AND_SHEETS,1381,3588,200,331821,80%
3607,MLB-NETWORK_CARDS,668,1538,200,332021,80%
2056,MLB-STOOLS,927,4380,199,332220,80%
2512,MLB-FISHING_RODS,1476,4017,199,332419,80%
3019,MLB-SPORT_SHORTS,1925,5305,198,332617,81%
3503,MLB-ELECTRIC_AIR_PUMPS,168,897,198,332815,81%
940,MLM-WELDING_CURTAINS,207,975,197,333012,81%
274,MLM-GAMEPADS_AND_JOYSTICKS,955,2463,196,333208,81%
2858,MLB-WALLPAPERS,2999,10395,196,333404,81%
3385,MLB-SAFETY_FOOTWEAR,978,3056,196,333600,81%
3997,MLB-FISHING_REELS,1577,4085,196,333796,81%
1972,MLB-BATHROOM_FAUCETS,1254,2477,195,333991,81%
2050,MLB-COMMERCIAL_AND_EVENT_BAGS,1181,2741,195,334186,81%
3157,MLB-TV_REMOTE_CONTROLS,946,1731,193,334379,81%
7,MLM-WALL_AND_CEILING_LIGHTS,1166,2604,191,334570,81%
2626,MLB-PLANTS,2281,4758,191,334761,81%
2983,MLB-ELECTRIC_SCREWDRIVERS,382,1747,191,334952,81%
3082,MLB-BABY_MONITORS,350,1475,191,335143,81%
2080,MLB-NAIL_POLISH,1688,4788,190,335333,81%
3005,MLB-GAME_CONSOLE_POWER_SUPPLIES,269,841,190,335523,81%
263,MLM-AEROBICS_AND_FITNESS_EQUIPMENT,818,1997,189,335712,81%
2123,MLB-BABY_CAR_SEATS,1232,4080,189,335901,81%
3845,MLB-FACIAL_TOWELS,281,1423,189,336090,81%
3847,MLB-DECORATIVE_NO_LIGHT_SIGNS,1066,4256,189,336279,81%
92,MLM-HEALTH_CARE_SUPPLIES,1026,1601,188,336467,81%
4833,MLB-TABLET_CASES,792,1782,188,336655,81%
2431,MLB-BABY_CLOTHING_SETS,1673,5984,186,336841,82%
2485,MLB-TV_RECEIVERS_AND_DECODERS,1294,3446,186,337027,82%
2005,MLB-BICYCLE_LIGHTS,796,2289,185,337212,82%
2120,MLB-SURVEILLANCE_MONITORING_KITS,806,3016,185,337397,82%
4154,MLB-PERMANENT_EPILATORS,380,1269,185,337582,82%
538,MLM-VEHICLE_LED_BULBS,486,1921,184,337766,82%
2890,MLB-UNDERWEAR_ORGANIZERS,617,1685,184,337950,82%
425,MLM-TELEPHONY_AND_RADIO_COMMUNICATION_PRODUCTS,417,2697,182,338132,82%
2097,MLB-BABY_CARRIERS,361,2053,181,338313,82%
3278,MLB-TOY_BUILDING_SETS,1964,3961,181,338494,82%
2082,MLB-GARDENING_AND_AGRICULTURE_SEEDS,2902,5283,180,338674,82%
3031,MLB-BED_SHEETS,1854,5711,180,338854,82%
4205,MLB-UNIVERSAL_CAR_REMOTES,308,1181,179,339033,82%
1593,MLB-SPORTS_AND_FITNESS,4356,7216,177,339210,82%
1976,MLB-DEODORANTS,684,1165,177,339387,82%
4181,MLB-HAND_BLENDERS,276,997,177,339564,82%
2686,MLB-MILK_EXTRACTORS,368,1451,176,339740,82%
5039,MLB-LAPTOP_STANDS,274,773,176,339916,82%
5,MLM-VEHICLE_ACCESSORIES,5025,7850,175,340091,82%
1780,MLB-QUILTS_AND_COVERLETS,2003,6377,174,340265,82%
440,MLM-HAIR_CLIPPERS,441,1766,173,340438,82%
1533,MLB-AUTOMOTIVE_TAIL_LIGHTS,2872,4186,173,340611,82%
948,MLM-FLEA_AND_TICK_TREATMENTS,198,665,171,340782,82%
2905,MLB-MAT_AND_LIQUID_REPELLENT_ELECTRIC_DEVICES,497,1357,171,340953,83%
4559,MLB-WEBCAMS,174,675,171,341124,83%
3076,MLB-SUSPENDERS,265,826,170,341294,83%
4924,MLB-EXERCISE_MATS,395,1696,170,341464,83%
5525,MLB-INSTANT_COFFEE,193,806,170,341634,83%
2828,MLB-NAIL_AND_CUTICLE_CUTTERS,534,1852,168,341802,83%
2541,MLB-RANGES,1533,6978,167,341969,83%
3960,MLB-ELECTRONIC_ENTRANCE_INTERCOMS,668,1893,166,342135,83%
1957,MLB-AIR_COMPRESSORS,641,1986,165,342300,83%
2870,MLB-COFFEE_MAKERS,1129,3252,165,342465,83%
2362,MLB-BODYSUITS_AND_CATSUITS,2160,6807,164,342629,83%
3199,MLB-KITCHEN_CABINETS,2262,8187,164,342793,83%
3666,MLB-MANICURE_AND_PEDICURE_ELECTRONIC_EXFOLIATORS_AND_FILES,281,1155,164,342957,83%
3766,MLB-MOTORCYCLE_COVERS,455,1119,164,343121,83%
4281,MLB-CURLING_IRONS,435,1369,164,343285,83%
1795,MLB-POWER_INVERTERS,635,1644,163,343448,83%
2004,MLB-CHAIR_COVERS,300,1161,162,343610,83%
3695,MLB-MAGNIFYING_GLASSES,390,1154,162,343772,83%
3914,MLB-AESTHETIC_TREATMENT_TABLES_AND_CHAIRS,337,1949,162,343934,83%
5034,MLB-HEAT_GUNS,197,673,162,344096,83%
375,MLM-TONERS,317,456,161,344257,83%
5131,MLB-AUDIO_CROSSOVERS,360,1493,161,344418,83%
17,MLM-GAME_CONSOLES_VIDEO_GAMES_AND_ARCADE_MACHINES,1501,2610,160,344578,83%
51,MLM-GYMNASTIC_KNEE_PADS,158,992,160,344738,83%
3015,MLB-WATCH_BANDS,950,2336,159,344897,83%
74,MLM-COMPUTER_MICE,454,1454,158,345055,84%
1007,MLM-ANTIVIRUS_AND_INTERNET_SECURITY,68,236,158,345213,84%
4259,MLB-NOTEBOOK_CASES,420,879,158,345371,84%
286,MLM-MILK_EXTRACTORS,203,1058,157,345528,84%
2562,MLB-MOTORCYCLE_HEADLIGHTS,800,2315,157,345685,84%
3650,MLB-SHAVING_MACHINES,267,994,157,345842,84%
3803,MLB-SUBMERSIBLE_PUMPS,301,1316,157,345999,84%
467,MLM-INK_CARTRIDGES,528,873,156,346155,84%
309,MLM-VIBRATORS,389,1142,155,346310,84%
702,MLM-TELEPHONES,230,605,155,346465,84%
1760,MLB-CELLPHONES_AND_TELEPHONY,1217,2370,155,346620,84%
2205,MLB-DESKTOP_COMPUTER_POWER_SUPPLIES,807,1910,155,346775,84%
4592,MLB-WAX_WARMERS,311,1209,155,346930,84%
4661,MLB-MARKERS_AND_HIGHLIGHTERS,649,1697,155,347085,84%
960,MLM-SIM_CARDS,142,592,154,347239,84%
2507,MLB-FLATWARE_SETS,702,2337,154,347393,84%
2271,MLB-SANDER_MACHINES,759,2092,153,347546,84%
2104,MLB-DOG_POTTY_PADS,397,1111,152,347698,84%
2749,MLB-WARDROBES,2121,9806,152,347850,84%
300,MLM-SPORTSWEAR,844,1934,151,348001,84%
2058,MLB-FOOD_STORAGE_CONTAINERS,1775,3778,151,348152,84%
2633,MLB-CELLPHONE_PARTS,1142,2142,151,348303,84%
4646,MLB-FITNESS_TRAMPOLINES,134,1317,151,348454,84%
2488,MLB-ELECTRIC_POTS_SKILLETS_AND_RICE_COOKERS,593,2075,150,348604,84%
4248,MLB-EMERGENCY_LIGHTS,472,1368,150,348754,84%
232,MLM-TELEVISIONS,817,2855,148,348902,84%
3604,MLB-ORAL_IRRIGATORS,280,862,148,349050,84%
152,MLM-RINGS,1399,3434,147,349197,85%
2434,MLB-GARDEN_SPRAYERS,478,1171,147,349344,85%
2048,MLB-AUTOMOTIVE_SHIFT_LEVER_KNOBS,973,1615,145,349489,85%
2374,MLB-CAKE_STANDS,569,1747,145,349634,85%
3104,MLB-LAPTOP_KEYBOARDS,846,1170,145,349779,85%
31,MLM-BOOTS_AND_BOOTIES,2621,4785,144,349923,85%
262,MLM-FOG_LIGHTS,630,1711,144,350067,85%
2807,MLB-DECORATIVE_BLANKETS,335,1440,144,350211,85%
3047,MLB-TOWEL_SETS,547,2243,144,350355,85%
172,MLM-CAR_SCANNERS,289,877,143,350498,85%
225,MLM-TABLE_AND_DESK_LAMPS,588,1694,143,350641,85%
496,MLM-CARD_PAYMENT_TERMINALS,53,878,143,350784,85%
3025,MLB-BATHROOM_SINKS,1003,3487,143,350927,85%
34,MLM-BLOUSES,1349,2540,142,351069,85%
1145,MLM-AUTOMOTIVE_LED_LIGHT_BARS,180,1264,142,351211,85%
3421,MLB-CHRISTMAS_TREES,370,1686,142,351353,85%
3852,MLB-BUNION_CORRECTORS,190,586,142,351495,85%
271,MLM-OFFICE_SOFTWARE,224,237,141,351636,85%
1889,MLB-AUTOMOTIVE_WHEEL_COVERS,3492,5748,141,351777,85%
2978,MLB-SUNSCREENS,1107,2169,141,351918,85%
3994,MLB-SPHYGMOMANOMETERS,162,1053,141,352059,85%
5128,MLB-ANTIVIRUS_AND_INTERNET_SECURITY,118,215,141,352200,85%
3215,MLB-PHOTOGRAPHY_ACCESSORIES_AND_SPARE_PARTS,1419,2160,140,352340,85%
3982,MLB-PROJECTORS,871,2705,140,352480,85%
1890,MLB-MICROCONTROLLER_BOARDS,1358,2836,139,352619,85%
2116,MLB-MOUSE_PADS,516,1206,139,352758,85%
2884,MLB-LAPTOP_BATTERIES,907,1332,138,352896,85%
3616,MLB-ALARMS_AND_SENSORS,1275,2567,138,353034,85%
5641,MLB-BABY_GYMS,86,1202,138,353172,85%
1801,MLB-CAMPING_AND_FISHING_EQUIPMENT,2840,5223,136,353308,86%
6304,MLB-FAN_PROPELLERS,150,462,136,353444,86%
2933,MLB-PAJAMAS,877,2430,135,353579,86%
6768,MLB-SPEED_LADDERS,126,786,133,353712,86%
2388,MLB-FACE_MASKS,632,1614,132,353844,86%
2786,MLB-GRAPHICS_CARDS,1948,4298,132,353976,86%
3068,MLB-PILLOWS,859,2776,132,354108,86%
30,MLM-RESISTANCE_BANDS,194,919,131,354239,86%
4499,MLB-ELECTRICAL_TIMERS,221,599,131,354370,86%
5058,MLB-LIFE_JACKETS,383,1052,131,354501,86%
2001,MLB-HAIR_DYES_COLORANTS_DECOLORANTS,2248,4125,130,354631,86%
3336,MLB-TELEPHONY_AND_RADIO_COMMUNICATION_PRODUCTS,714,2997,130,354761,86%
4417,MLB-TOOL_MILLS,637,1424,129,354890,86%
2623,MLB-FISH_TANK_PUMPS,563,1234,128,355018,86%
2859,MLB-HAIR_STRAIGHTENING_BRUSHES,367,1274,128,355146,86%
3332,MLB-AUTOMOTIVE_ALARM_KITS,560,1506,127,355273,86%
4287,MLB-EROTIC_PUMPS,236,836,127,355400,86%
3714,MLB-BARBECUE_TOOL_SETS,959,2267,126,355526,86%
4671,MLB-CENTRIFUGAL_PUMPS,291,1113,126,355652,86%
2029,MLB-DRAIN_GRATES,455,1023,125,355777,86%
2691,MLB-BEAUTY_WIGS,988,2483,125,355902,86%
888,MLM-MANICURE_AND_PEDICURE_DRILLS,135,706,124,356026,86%
1897,MLB-TACTICAL_AND_SPORTING_KNIVES_AND_BLADES,2029,4807,124,356150,86%
301,MLM-MATTRESSES,455,1848,123,356273,86%
364,MLM-TV_REMOTE_CONTROLS,341,717,123,356396,86%
2728,MLB-FRAGRANCE_SETS,714,1909,123,356519,86%
155,MLM-FLOOD_LIGHTS,315,995,122,356641,86%
1352,MLM-STETHOSCOPES,144,718,122,356763,86%
2732,MLB-MICROSCOPES,294,808,122,356885,86%
2791,MLB-PARKING_SENSORS,412,1074,122,357007,86%
3017,MLB-ELECTRIC_DOUGH_SHEETERS,125,698,122,357129,86%
3026,MLB-PASTRY_TIPS,480,1630,122,357251,86%
3125,MLB-NAIL_STRENGTHENERS,595,1356,122,357373,86%
3592,MLB-STRING_INSTRUMENT_STANDS_AND_WALL_HANGERS,197,442,122,357495,87%
5941,MLB-TRAILER_HITCH_COUPLERS,71,441,122,357617,87%
478,MLM-BLENDERS,294,1065,121,357738,87%
1761,MLB-DOG_BEDS,1071,3244,121,357859,87%
2117,MLB-HEADBOARDS,1069,3812,119,357978,87%
3697,MLB-BED_AND_CRIB_SAFETY_RAILS,134,545,119,358097,87%
466,MLM-SKIN_CARE_SUPPLIES,563,1001,118,358215,87%
1722,MLB-VIBRATORS,841,1995,118,358333,87%
2739,MLB-ELECTRIC_JUGS,228,835,118,358451,87%
3403,MLB-BICYCLE_TIRES,961,2008,118,358569,87%
883,MLM-BICYCLE_LIGHTS,287,1208,117,358686,87%
3270,MLB-BABY_MOBILES,460,1251,117,358803,87%
5093,MLB-BABY_HARNESSES,80,431,117,358920,87%
4811,MLB-CALIPERS,188,528,116,359036,87%
964,MLM-MENSTRUAL_CUPS,134,830,115,359151,87%
1793,MLB-LIPSTICKS,1363,2898,115,359266,87%
2855,MLB-SATELLITE_FINDERS,337,1025,115,359381,87%
3227,MLB-NON_RETURN_DRAIN_VALVES,178,658,115,359496,87%
130,MLM-SUSPENDERS,98,633,114,359610,87%
524,MLM-OIL_DIFFUSERS,208,819,114,359724,87%
2891,MLB-WRISTWATCH_SCREEN_PROTECTORS,194,680,114,359838,87%
3427,MLB-BABY_BODYSUITS,2079,4708,114,359952,87%
4899,MLB-ABDOMINAL_TONING_BELTS,213,790,114,360066,87%
222,MLM-PAJAMAS,332,1276,113,360179,87%
2496,MLB-BATHROOM_ACCESSORIES_SETS,978,2423,113,360292,87%
2504,MLB-POWER_SAVERS,211,870,113,360405,87%
571,MLM-DIAPER_BAGS,300,1562,112,360517,87%
2000,MLB-MOTORCYCLE_TIRES,2696,4373,112,360629,87%
2219,MLB-SEWING_MACHINE_PRESSER_FEET,805,1434,112,360741,87%
3154,MLB-WOMEN_SPORT_SWIMWEAR,170,546,112,360853,87%
3548,MLB-PAINT_ROLLERS,218,778,112,360965,87%
4193,MLB-BATH_TOWELS,477,1372,112,361077,87%
2644,MLB-GRAPHICS_TABLETS,243,693,111,361188,87%
4808,MLB-MANICURE_AND_PEDICURE_DRILLS,333,1434,111,361299,87%
264,MLM-OFFICE_CHAIRS,339,979,110,361409,87%
353,MLM-ONE_PIECE_PAJAMAS,191,1089,110,361519,88%
462,MLM-MOTORCYCLE_GLOVES,264,1109,110,361629,88%
2918,MLB-DISPOSABLE_GLOVES,286,524,110,361739,88%
3551,MLB-FOOTBALL_GOALKEEPER_GLOVES,550,1441,110,361849,88%
3677,MLB-EMPLOYEE_TIME_CLOCKS,169,369,110,361959,88%
662,MLM-OUTDOOR_TABLES,167,621,108,362067,88%
2163,MLB-BABY_CUSHIONS_AND_PILLOWS,580,1810,108,362175,88%
2298,MLB-WALL_CLOCKS,745,2021,108,362283,88%
2934,MLB-TRAMPOLINES,336,2244,108,362391,88%
3391,MLB-E_READERS,278,728,108,362499,88%
3490,MLB-KITCHEN_TOWELS,599,1865,108,362607,88%
260,MLM-LEGGINGS,719,2119,107,362714,88%
2389,MLB-FISHING_LURES,1295,2874,107,362821,88%
2643,MLB-HEADLAMPS,293,974,107,362928,88%
4083,MLB-BABY_STROLLER_MOSQUITO_COVERS,207,649,107,363035,88%
2713,MLB-HAND_POLISHERS,569,1580,106,363141,88%
2215,MLB-HAIR_ROLLERS,778,1756,105,363246,88%
3159,MLB-OFFICE_EQUIPMENT,372,926,105,363351,88%
3786,MLB-AUDIO_AMPLIFIERS,845,2772,105,363456,88%
52,MLM-NAIL_DRYERS,245,813,104,363560,88%
1954,MLB-BEER_DISPENSERS,429,1751,104,363664,88%
2887,MLB-MOTORCYCLE_EXHAUSTS,1884,3471,104,363768,88%
3004,MLB-BEAUTY_APPLIANCES,547,1360,104,363872,88%
3214,MLB-SPICE_RACKS,532,1479,104,363976,88%
3569,MLB-MICRO_ROTARY_TOOLS,383,1439,104,364080,88%
2754,MLB-SARONGS,621,1787,103,364183,88%
3131,MLB-BALLOONS,1044,2166,103,364286,88%
4336,MLB-VEHICLE_WAXES,818,1777,103,364389,88%
134,MLM-WELDING_MACHINES,510,1624,102,364491,88%
278,MLM-TEA,191,413,102,364593,88%
2518,MLB-HOME_DECOR,2783,4730,102,364695,88%
4242,MLB-PH_METERS,172,512,102,364797,88%
46,MLM-GAME_CONSOLES,1402,3128,101,364898,88%
1580,MLB-STABILIZERS_AND_UPS,372,857,101,364999,88%
2017,MLB-DRONES,1312,3689,101,365100,88%
2351,MLB-PET_BRUSHES,247,621,101,365201,88%
3476,MLB-ARTIFICIAL_FLOWERS,1141,2716,101,365302,88%
3817,MLB-ESPADRILLES,415,1166,101,365403,88%
2315,MLB-VEHICLE_GAUGE_HOLDERS,2581,3589,100,365503,88%
2523,MLB-BABY_STROLLERS,1066,2579,100,365603,88%
3098,MLB-BOARD_GAMES,1927,3416,100,365703,89%
503,MLM-AUTOMOTIVE_CELLPHONE_AND_GPS_MOUNTS,414,1226,99,365802,89%
519,MLM-SHOWER_HEADS,118,619,99,365901,89%
2701,MLB-POOL_COVERS,563,1228,99,366000,89%
2981,MLB-CELLPHONE_USB_AND_AUXILIARY_ADAPTERS,504,1186,99,366099,89%
3181,MLB-FOOTBALL_BALLS,695,1571,99,366198,89%
4333,MLB-PLAYGROUND_SLIDES,237,2298,99,366297,89%
4841,MLB-JUMP_ROPES,231,630,99,366396,89%
5013,MLB-COMPRESSION_SLEEVES,260,570,99,366495,89%
5554,MLB-BABY_ACTIVITY_TABLES,129,605,99,366594,89%
395,MLM-MICROPHONES,456,1245,98,366692,89%
2834,MLB-CIGARETTE_PAPERS,583,1375,98,366790,89%
3163,MLB-MICROBLADING_NEEDLES,508,1249,98,366888,89%
3424,MLB-BELTS,978,2095,98,366986,89%
3784,MLB-POOL_WATERFALLS,220,878,98,367084,89%
2564,MLB-NETWORK_CABLES,785,1244,97,367181,89%
3115,MLB-CUSHION_AND_PILLOW_COVERS,812,1869,97,367278,89%
3831,MLB-CLAMP_METERS,359,822,97,367375,89%
3942,MLB-OIL_DIFFUSERS,632,1537,97,367472,89%
4271,MLB-COMBUSTION_CHAINSAWS,346,1189,97,367569,89%
4278,MLB-POWER_STRIPS,1034,2124,97,367666,89%
5483,MLB-PILATES_BALLS,279,802,97,367763,89%
2629,MLB-AUTOMOTIVE_ARMRESTS,1084,2274,96,367859,89%
3103,MLB-DESKTOP_COMPUTER_COOLERS_AND_FANS,1054,1964,96,367955,89%
5183,MLB-MUSIC_MOVIES_AND_TV_SERIES,243,523,96,368051,89%
5396,MLB-PORTABLE_HANGING_SCALES,133,319,96,368147,89%
2034,MLB-BABY_BOTTLES,680,1651,95,368242,89%
3767,MLB-TAG_PIN_GUNS,81,322,95,368337,89%
4436,MLB-BOOTS,633,1780,95,368432,89%
91,MLM-PANTS,1383,2739,94,368526,89%
946,MLM-KEYBOARD_AND_MOUSE_KITS,274,1084,94,368620,89%
1956,MLB-MIXERS,614,1975,94,368714,89%
3283,MLB-ACOUSTIC_GUITARS,1530,3755,94,368808,89%
3515,MLB-HOME_OFFICE_DESKS,1029,3665,94,368902,89%
4542,MLB-BOOKCASES,357,1106,94,368996,89%
2871,MLB-KEYCHAINS,2012,3008,92,369088,89%
86,MLM-LIGHT_BULBS,506,1220,91,369179,89%
89,MLM-AUTOMOTIVE_TIRES,1270,1832,91,369270,89%
3048,MLB-HUNTING_NETS,735,1727,91,369361,89%
318,MLM-PASTRY_TIPS,164,767,90,369451,89%
3059,MLB-AUTOMOTIVE_SPEAKER_BOXES,1288,6439,90,369541,89%
3710,MLB-AUTOMOTIVE_WEATHERSTRIPS,1507,2015,90,369631,89%
4212,MLB-SOLDERING_IRONS,490,1177,90,369721,89%
149,MLM-ELECTRONIC_MUSCLE_STIMULATORS,161,582,89,369810,90%
1796,MLB-JIG_SAWS,219,971,89,369899,90%
2519,MLB-DINING_SETS,1061,4091,89,369988,90%
2982,MLB-IRONS,461,1081,89,370077,90%
3556,MLB-MAKEUP,900,1574,89,370166,90%
4838,MLB-BARBELL_WEIGHT_SETS,185,963,89,370255,90%
2798,MLB-MANUAL_STAPLERS_AND_BRAD_NAILERS,155,437,88,370343,90%
194,MLM-LIPSTICKS,499,1465,87,370430,90%
1968,MLB-BEDS,1956,5755,87,370517,90%
3979,MLB-BABY_TEETHING_BRACELETS_AND_NECKLACES,60,328,87,370604,90%
124,MLM-MAKEUP,508,1053,86,370690,90%
418,MLM-AUTOMOTIVE_CONTROL_ALARM_CASES,643,1016,86,370776,90%
2454,MLB-VIDEO_CAMERAS,1058,2998,86,370862,90%
2853,MLB-TOOTHPASTES,296,475,86,370948,90%
3633,MLB-PLUNGE_ROUTERS,341,979,86,371034,90%
4132,MLB-DOORBELLS,248,732,86,371120,90%
1892,MLB-MICROBLADING_PIGMENTS,202,656,85,371205,90%
335,MLM-COOKTOPS,322,989,84,371289,90%
2854,MLB-TOY_REFRIGERATORS,157,852,84,371373,90%
3051,MLB-STYLUSES,255,678,84,371457,90%
3493,MLB-WATER_AND_EXTREME_SPORTS_EQUIPMENT,310,869,84,371541,90%
3625,MLB-MOTORCYCLE_SHOCK_ABSORBERS,617,1190,84,371625,90%
1961,MLB-AEROBICS_AND_FITNESS_EQUIPMENT,1457,2433,83,371708,90%
2620,MLB-COMPUTER_MOTHERBOARDS,2898,5389,83,371791,90%
2693,MLB-SERVING_AND_HOME_TRAYS,1149,2064,83,371874,90%
3260,MLM-VIBRATION_PLATFORMS,11,230,83,371957,90%
3652,MLB-EYESHADOWS,1117,2964,83,372040,90%
4080,MLB-POUFS,913,2561,83,372123,90%
5449,MLB-BABY_WRAP_SLINGS,73,483,83,372206,90%
107,MLM-PARTY_SUPPLIES,1146,1768,82,372288,90%
266,MLM-HATS_AND_CAPS,1691,2948,82,372370,90%
841,MLM-ELECTRIC_AIR_PUMPS,67,392,82,372452,90%
3275,MLB-MIRRORS,637,1268,82,372534,90%
4172,MLB-TONERS,609,709,82,372616,90%
388,MLM-CANDLES,228,589,81,372697,90%
3546,MLB-SUN_UMBRELLAS,316,962,81,372778,90%
3646,MLB-FANNY_PACKS,569,1102,81,372859,90%
62,MLM-ACTION_FIGURES,4981,6330,80,372939,90%
184,MLM-PLAGUES_ULTRASONIC_REPELLENTS,268,667,80,373019,90%
644,MLM-VACUUM_CLEANERS,232,595,80,373099,90%
3489,MLB-SPORTSWEAR,1319,2280,80,373179,90%
3529,MLB-BAR_CODE_SCANNERS,221,447,80,373259,90%
4176,MLB-CELLPHONE_SELFIE_LIGHTS,119,538,80,373339,90%
5370,MLB-BICYCLE_SEATS,320,826,80,373419,90%
2985,MLB-WASTE_BASKETS,767,1578,79,373498,90%
3269,MLB-FLAGS,246,520,79,373577,90%
3628,MLB-OUTDOOR_TABLES,352,1032,79,373656,90%
3777,MLB-BABY_WALKERS,384,1321,79,373735,90%
5281,MLB-RIBBON_AND_ROPE_THERMAL_CUTTERS,157,554,79,373814,90%
6659,MLB-AIR_MATTRESSES,269,1024,79,373893,90%
1142,MLM-BABY_CARRIERS,162,880,78,373971,91%
2980,MLB-ANTI_SNORE_CHIN_STRAPS,226,518,78,374049,91%
4379,MLB-KITCHEN_SINKS,542,1485,78,374127,91%
24,MLM-KITCHEN_SUPPLIES,1900,2890,77,374204,91%
108,MLM-MUGS,669,1239,77,374281,91%
3987,MLB-TOY_CASH_REGISTERS,211,916,77,374358,91%
828,MLM-WALKIE_TALKIES,208,668,76,374434,91%
3359,MLB-CAR_SCREENS,441,1217,76,374510,91%
6810,MLB-WIRE_STRIPPERS,174,546,76,374586,91%
768,MLM-DILDOS,218,657,75,374661,91%
2405,MLB-BATHROOM_SUPPLIES,1100,2046,75,374736,91%
3940,MLB-IDENTIFICATION_AND_PRESENTATION_CARDS,435,961,75,374811,91%
4326,MLB-TROLLEY_AND_FURNITURE_CASTERS,407,667,75,374886,91%
4826,MLB-TV_ANTENNAS,415,987,75,374961,91%
162,MLM-PC_KEYBOARDS,497,1122,74,375035,91%
673,MLM-SPORT_WATCHES,299,1392,74,375109,91%
1001,MLM-HOME_LIGHTING_SUPPLIES,601,1139,74,375183,91%
1735,MLM-KIDS_TENTS,38,371,74,375257,91%
2475,MLB-ADHESIVE_TAPES,293,449,74,375331,91%
2721,MLB-MARTIAL_ARTS_AND_BOXING_EQUIPMENT,1003,1567,74,375405,91%
3678,MLB-HABERDASHERY_SUPPLIES,1528,2709,74,375479,91%
5416,MLB-HYGROMETERS,174,429,74,375553,91%
1599,MLB-AUTOMOTIVE_CONTROL_ALARM_CASES,613,804,73,375626,91%
2604,MLB-BEDDING,674,1397,73,375699,91%
3561,MLB-DRINK_DISPENSERS,242,663,73,375772,91%
4163,MLB-SORTING_AND_STACKING_TOYS,218,1126,73,375845,91%
4630,MLB-TOOTHBRUSH_HOLDERS,185,552,73,375918,91%
5745,MLB-CONSTRUCTION_INSULATION_ROLLS,83,324,73,375991,91%
393,MLM-WATER_DISPENSERS,141,542,72,376063,91%
1106,MLM-MANUAL_DRINKING_WATER_PUMPS,59,310,72,376135,91%
1798,MLB-MUGS,2274,3386,72,376207,91%
2471,MLB-KITCHEN_RANGE_HOODS,484,1242,72,376279,91%
3463,MLB-ELECTRIC_HAND_PLANERS,247,695,72,376351,91%
3528,MLB-KITCHEN_POTS,911,2246,72,376423,91%
3634,MLB-SMART_SPEAKERS,223,592,72,376495,91%
4993,MLB-MANUAL_FACIAL_BRUSHES_AND_SPONGES,144,658,72,376567,91%
5970,MLB-BABY_CREAMS_AND_OINTMENTS,219,363,72,376639,91%
576,MLM-BRAS,387,829,71,376710,91%
2085,MLB-CHARMS_AND_MEDALS,1205,2276,71,376781,91%
2630,MLB-HAIRDRESSING_TRAINING_HEADS,182,672,71,376852,91%
2830,MLB-CYCLING_SETS,537,1440,71,376923,91%
3028,MLB-SUN_TANNER_PRODUCTS,326,970,71,376994,91%
3342,MLB-NIGHTSTANDS,816,2235,71,377065,91%
3676,MLB-AM_FM_RADIOS,470,923,71,377136,91%
3205,MLB-ELECTRONIC_LOCKS,543,1243,70,377206,91%
3506,MLB-PACKAGING_BOXES,333,381,70,377276,91%
3617,MLB-GPS,482,1174,70,377346,91%
3632,MLB-BLOOD_GLUCOSE_METERS,296,622,70,377416,91%
2039,MLB-WASHING_MACHINE_CONTROL_BOARDS,749,1066,69,377485,91%
3889,MLB-HAIR_MOLDING_AND_STYLING,454,847,69,377554,91%
96,MLM-CLOTHING,1122,1805,68,377622,91%
291,MLM-HAIR_STRAIGHTENING_BRUSHES,80,289,68,377690,91%
305,MLM-FOOTBALL_SHIRTS,1134,1974,68,377758,91%
592,MLM-SCHOOL_AND_OFFICE_PAPERS,276,457,68,377826,91%
920,MLM-WATCH_BANDS,545,1864,68,377894,91%
1756,MLB-ELECTRIC_BLOWERS,148,373,68,377962,91%
2684,MLB-MOTORCYCLE_GLOVES,642,1470,68,378030,91%
3195,MLB-DINING_CHAIRS,814,2563,68,378098,92%
3411,MLB-BATHROOM_VANITIES,716,3345,68,378166,92%
3595,MLB-FLOORS_WALLS_AND_APERTURES,516,1268,68,378234,92%
3945,MLB-RABBIT_AND_RODENT_CAGES,239,931,68,378302,92%
4148,MLB-AIR_FRESHENERS,211,538,68,378370,92%
4195,MLB-ELECTRIC_SANDWICH_MAKERS,364,1178,68,378438,92%
5200,MLB-EXTERNAL_LAPTOP_COOLERS,230,638,68,378506,92%
5246,MLB-ELECTRIC_BRUSH_CUTTERS_AND_STRING_TRIMMERS,100,314,68,378574,92%
5616,MLB-PRESENTATION_REMOTES,122,355,68,378642,92%
5899,MLB-FOG_MACHINES,227,679,68,378710,92%
548,MLM-FOOTWEAR,429,729,67,378777,92%
939,MLM-WIRELESS_FM_TRANSMITTERS,151,558,67,378844,92%
2272,MLB-CUT_OFF_AND_GRINDING_WHEELS,1061,1775,67,378911,92%
2784,MLB-BABY_GROOMING_KITS,549,1526,67,378978,92%
3865,MLB-MOSQUITO_NETS,297,749,67,379045,92%
4530,MLB-TELESCOPES,272,1107,67,379112,92%
5701,MLB-LASER_POINTERS,101,393,67,379179,92%
59,MLM-ACOUSTIC_GUITARS,369,1041,66,379245,92%
603,MLM-AUTOMOTIVE_MATS,398,650,66,379311,92%
707,MLM-GAME_CONSOLE_POWER_SUPPLIES,161,505,66,379377,92%
1748,MLB-AUTOMOTIVE_SHOCK_ABSORBERS,3484,4752,66,379443,92%
2113,MLB-BORESCOPES,79,332,66,379509,92%
2506,MLB-SPORT_T_SHIRTS,1126,2610,66,379575,92%
2552,MLB-CLOGS_AND_MULES,1095,2539,66,379641,92%
2571,MLB-PENS,1042,1406,66,379707,92%
2668,MLB-LIP_BALMS,1111,2873,66,379773,92%
2845,MLB-CAR_RACE_TRACKS_AND_BLAST_LAUNCHERS,449,1369,66,379839,92%
4864,MLB-BLENDER_JARS,425,708,66,379905,92%
686,MLM-KITCHEN_GRATERS,102,395,65,379970,92%
929,MLM-NOSE_SHAPERS,43,249,65,380035,92%
2673,MLB-CAR_AC_DASHBOARD_VENTS,922,1378,65,380100,92%
2847,MLB-VISES,361,1173,65,380165,92%
3350,MLB-ELECTRIC_BROOMS,156,494,65,380230,92%
3754,MLB-BABY_BIBS,195,695,65,380295,92%
4901,MLB-BENCH_POLISHERS,120,487,65,380360,92%
302,MLM-NECK_GAITERS_MASKS_AND_BALACLAVAS,280,753,64,380424,92%
382,MLM-CHRISTMAS_LIGHTS,387,980,64,380488,92%
1511,MLM-TOOTHBRUSHES,183,567,64,380552,92%
2432,MLB-CLEANING_MOP_REPLACEMENTS,141,391,64,380616,92%
3014,MLB-MOTORCYCLE_CARBURETORS,639,1106,64,380680,92%
3141,MLB-DOLL_STROLLERS,318,1353,64,380744,92%
3432,MLB-BICYCLE_AND_MOTORCYCLE_ALARMS,317,713,64,380808,92%
5019,MLB-VEHICLE_COOLANTS,234,408,64,380872,92%
5612,MLB-PRINTER_SUPPLIES_KITS,98,198,64,380936,92%
238,MLM-FANNY_PACKS,269,747,63,380999,92%
259,MLM-TOYS_AND_GAMES,2355,3320,63,381062,92%
3212,MLB-COMMERCIAL_SOFTWARE,583,1040,63,381125,92%
3253,MLB-PET_COLLARS,443,960,63,381188,92%
3323,MLM-DRY_BAGS,18,306,63,381251,92%
4956,MLB-DOG_BARK_CONTROL_COLLARS,90,281,63,381314,92%
18,MLM-ELECTRICAL_CABLES,149,388,62,381376,92%
49,MLM-HOME_SUPPLIES,1263,1791,62,381438,92%
114,MLM-THERMOSES,615,1304,62,381500,92%
2522,MLB-AQUARIUM_FILTERS,561,1255,62,381562,92%
2818,MLB-GYM_GLOVES,317,805,62,381624,92%
3065,MLB-DARTS,383,924,62,381686,92%
3962,MLB-SOUND_CONSOLES_AND_MIXERS,657,1381,62,381748,92%
5043,MLB-WASHING_AND_DRYER_MACHINE_COVERS,232,501,62,381810,92%
68,MLM-VEHICLE_PARTS,3012,3741,61,381871,92%
95,MLM-MEDICAL_EQUIPMENT,359,559,61,381932,92%
373,MLM-CELLPHONES_AND_TELEPHONY,329,695,61,381993,92%
427,MLM-EYELASH_EXTENSIONS,313,893,61,382054,92%
626,MLM-ENGINE_OILS,286,458,61,382115,92%
876,MLM-POWER_GRINDERS,174,490,61,382176,93%
971,MLM-STABILIZERS_AND_UPS,169,427,61,382237,93%
2672,MLB-LUMBAR_AND_ABDOMINAL_BRACES,273,686,61,382298,93%
4027,MLB-USB_HUBS,279,432,61,382359,93%
4852,MLB-COMPLETE_SKATEBOARDS,339,1124,61,382420,93%
285,MLM-SPORT_PANTS,334,1015,60,382480,93%
435,MLM-MAKEUP_SETS,293,840,60,382540,93%
1575,MLB-CUSHIONS,1207,2739,60,382600,93%
2090,MLB-AUTOMOTIVE_ANGEL_EYES,422,1091,60,382660,93%
2735,MLB-KITCHEN_SHOVELS_AND_SPATULAS,262,764,60,382720,93%
3301,MLB-PUSH_AND_RIDING_TOYS,435,1443,60,382780,93%
3995,MLB-LAMINATORS,145,466,60,382840,93%
4241,MLB-HAND_SAWS,190,473,60,382900,93%
4468,MLB-CHARCOAL_GRILLS,692,2354,60,382960,93%
6277,MLB-PREGNANCY_AND_OVULATION_TESTS,72,247,60,383020,93%
543,MLM-BLOOD_PRESSURE_MONITORS,66,220,59,383079,93%
2103,MLB-AIRGUN_PELLETS,299,888,59,383138,93%
3381,MLB-BABIES_FORMULA,286,516,59,383197,93%
3555,MLB-NAIL_DUST_COLLECTORS,219,947,59,383256,93%
3568,MLB-MANUAL_MASSAGERS,298,680,59,383315,93%
5293,MLB-MICROPHONE_STANDS,203,541,59,383374,93%
6897,MLB-INFLATABLE_BOUNCE_HOUSES,119,448,59,383433,93%
205,MLM-HOME_DECOR,1269,1951,58,383491,93%
221,MLM-ESSENTIAL_OILS,353,611,58,383549,93%
298,MLM-BABYDOLLS,523,1223,58,383607,93%
1997,MLB-ICE_BUCKETS,257,593,58,383665,93%
3400,MLB-SPORT_PROTECTIVE_GEAR_SETS,190,704,58,383723,93%
4023,MLB-TAMBOURINES,224,547,58,383781,93%
4616,MLB-PEDAL_EXERCISERS,51,276,58,383839,93%
5384,MLB-PC_THERMAL_COMPOUND_PASTES,201,377,58,383897,93%
6791,MLB-BABY_SAFETY_LOCKS,82,271,58,383955,93%
48,MLM-SOUVENIRS,1549,2179,57,384012,93%
140,MLM-MOTORCYCLE_HELMETS,916,1926,57,384069,93%
762,MLM-SOFA_AND_FUTON_COVERS,107,349,57,384126,93%
1010,MLM-BABY_GYMS,65,312,57,384183,93%
3409,MLB-MAKEUP_ILLUMINATORS,309,805,57,384240,93%
3410,MLB-AUTOMOTIVE_AIR_FILTERS,801,1057,57,384297,93%
3514,MLB-PLUG_ADAPTERS,334,456,57,384354,93%
3549,MLB-CORSETS,322,840,57,384411,93%
3918,MLB-DOLL_CLOTHES,360,1284,57,384468,93%
4402,MLB-DOOR_PULL_AND_PUSH_HANDLES,333,848,57,384525,93%
4470,MLB-HAIR_REMOVAL_KITS,188,817,57,384582,93%
258,MLM-FACE_MASKS,356,981,56,384638,93%
432,MLM-SURVEILLANCE_MONITORING_KITS,238,840,56,384694,93%
2515,MLB-RATTLES,213,743,56,384750,93%
2568,MLB-SUNBATHING_CHAIRS,515,1557,56,384806,93%
2813,MLB-VESTS,772,1797,56,384862,93%
2984,MLB-INFLATABLE_BALL_PITS,334,1448,56,384918,93%
3502,MLB-CAR_HORNS,354,758,56,384974,93%
3947,MLB-TRAMPOLINE_SPRINGS,207,424,56,385030,93%
4161,MLB-PEPPER_SPRAYS,161,404,56,385086,93%
4652,MLB-BABY_URINALS,76,269,56,385142,93%
5938,MLB-ORTHOPEDIC_SHOULDER_PADS,61,223,56,385198,93%
315,MLM-LOAFERS_AND_OXFORDS,734,1136,55,385253,93%
1199,MLM-HARD_DRIVE_AND_SSD_ENCLOSURES,143,377,55,385308,93%
2559,MLB-TORQUE_WRENCHES,138,530,55,385363,93%
2653,MLB-AEROBIC_CRUNCH_MACHINES,84,383,55,385418,93%
3204,MLB-POTTIES,317,716,55,385473,93%
5447,MLB-ELECTRIC_MASSAGE_PILLOWS,132,360,55,385528,93%
4,MLM-NOTEBOOKS,1683,3587,54,385582,93%
56,MLM-POGS,148,430,54,385636,93%
138,MLM-SPORTSWEAR_SETS,311,1176,54,385690,93%
283,MLM-DRILLS_SCREWDRIVERS,146,660,54,385744,93%
932,MLM-DEPILATORY_WAXES,78,240,54,385798,93%
1971,MLB-DRIED_FRUITS,295,708,54,385852,93%
3640,MLB-CAMERA_LENSES,899,1140,54,385906,93%
4994,MLB-LABEL_MAKERS,125,287,54,385960,93%
508,MLM-NETWORK_CABLES,244,426,53,386013,93%
982,MLM-MODEMS,171,544,53,386066,93%
1848,MLB-HANDICRAFT_BOXES,1235,1766,53,386119,93%
2301,MLB-GYM_BARS,271,876,53,386172,93%
2842,MLB-GRILL_GRATES,384,978,53,386225,93%
3140,MLB-TOILETRY_BAGS,533,1042,53,386278,93%
3356,MLB-CANDLES,399,654,53,386331,94%
3635,MLB-PASTRY_MAKING_SETS,367,1026,53,386384,94%
4009,MLB-TOY_KEYBOARDS_AND_PIANOS,228,658,53,386437,94%
4421,MLB-CYCLING_HELMETS,696,1489,53,386490,94%
26,MLM-EYESHADOWS,663,1490,52,386542,94%
2101,MLB-AUTOMOTIVE_MATS,3509,5066,52,386594,94%
2558,MLB-HOME_THEATERS,599,2278,52,386646,94%
3272,MLB-SPORT_AND_BAZAAR_BOTTLES,571,974,52,386698,94%
3334,MLB-HOUSE_NUMBERS,203,429,52,386750,94%
3417,MLB-SCULPTURED_NAIL_BUILDER_GELS,340,888,52,386802,94%
3993,MLB-CALCULATORS,377,564,52,386854,94%
4020,MLB-KERCHIEFS_AND_PASHMINAS,279,552,52,386906,94%
4156,MLB-CAR_DISTRIBUTOR_KITS,91,186,52,386958,94%
5160,MLB-CELLPHONE_CAMERA_ATTACHMENTS,188,516,52,387010,94%
5392,MLB-MALE_MASTURBATORS,367,917,52,387062,94%
6280,MLB-WATER_PURIFIER_FILTERS_REFILLS,61,115,52,387114,94%
272,MLM-PILLOWS,247,488,51,387165,94%
411,MLM-TOILETRY_BAGS,256,979,51,387216,94%
414,MLM-DRILL_BITS,455,798,51,387267,94%
3414,MLB-HAIRDRESSING_CAPS,290,600,51,387318,94%
5092,MLB-DVD_RECORDERS,182,384,51,387369,94%
5676,MLB-KARAOKE_MICROPHONES,33,216,51,387420,94%
6444,MLB-HAIR_TIES,87,282,51,387471,94%
1133,MLM-SAFES,245,643,50,387521,94%
2341,MLB-CAMERAS,1922,2874,50,387571,94%
2957,MLB-VINYL_ROLLS,499,1106,50,387621,94%
3656,MLB-DECORATIVE_AND_PROMOTIONAL_MAGNETS,178,486,50,387671,94%
3720,MLB-BIRD_TOYS,1089,2304,50,387721,94%
3742,MLB-UNIVERSAL_REMOTE_CONTROLS,156,311,50,387771,94%
4233,MLB-SPORTSWEAR_SETS,397,1652,50,387821,94%
4400,MLB-COTTON_CANDY_MACHINES,128,601,50,387871,94%
5519,MLB-DECORATIVE_LIGHT_SIGNS,200,448,50,387921,94%
431,MLM-WALL_AND_DOOR_EXERCISE_BARS,111,540,49,387970,94%
554,MLM-GYM_GLOVES,161,482,49,388019,94%
619,MLM-TV_AND_MONITOR_MOUNTS,158,344,49,388068,94%
2402,MLB-PHOTOGRAPHY_BACKDROPS,431,928,49,388117,94%
2727,MLB-COINS,1165,1841,49,388166,94%
2737,MLB-MUSICAL_INSTRUMENT_ACCESSORIES,1580,2246,49,388215,94%
3290,MLB-AIRBRUSHES,243,492,49,388264,94%
4273,MLB-SOIL_FERTILIZERS,289,516,49,388313,94%
5952,MLB-AIRTIGHT_BAGS,112,222,49,388362,94%
358,MLM-SHAVING_MACHINES,52,217,48,388410,94%
412,MLM-ANKLE_AND_WRIST_WEIGHTS,167,460,48,388458,94%
1447,MLM-BABY_WRAP_SLINGS,66,325,48,388506,94%
2652,MLB-SOFAS,2722,8088,48,388554,94%
3360,MLB-PERSONAL_LUBRICANTS_AND_GELS,518,1014,48,388602,94%
4112,MLB-RAZOR_CARTRIDGES,133,257,48,388650,94%
4692,MLB-TOOL_BAGS_AND_BACKPACKS,310,814,48,388698,94%
2094,MLB-WHISKEYS,606,1273,47,388745,94%
2879,MLB-ANIMAL_AND_BALL_HOPPERS,145,457,47,388792,94%
3244,MLB-BATHROOM_GRAB_BARS,119,324,47,388839,94%
3711,MLB-SCHOOL_MODELING_CLAYS,111,469,47,388886,94%
5836,MLB-VIOLINS,211,531,47,388933,94%
511,MLM-CHRISTMAS_TREES,327,787,46,388979,94%
1723,MLB-PLANTING_KITS,780,1351,46,389025,94%
2690,MLB-MASSAGE_EQUIPMENT,460,976,46,389071,94%
3133,MLB-FISH_FOODS,440,755,46,389117,94%
3740,MLB-MOTORCYCLE_TURN_SIGNAL_LIGHTS,630,1060,46,389163,94%
4565,MLB-ELECTRICAL_CABLES,481,976,46,389209,94%
4794,MLB-AUTOMOTIVE_STEERING_WHEEL_LOCKS,360,626,46,389255,94%
5313,MLB-IDENTIFICATION_WRISTBANDS,62,164,46,389301,94%
5465,MLB-BED_AND_CRIB_CANOPIES,180,484,46,389347,94%
183,MLM-SHIRTS,965,1733,45,389392,94%
552,MLM-FOODS_AND_DRINKS,640,879,45,389437,94%
2016,MLB-ELECTRICITY_METERS,231,450,45,389482,94%
2348,MLB-FISHING_SHIRTS,305,710,45,389527,94%
2769,MLB-TABLET_SCREENS,290,456,45,389572,94%
3233,MLB-DENTAL_EQUIPMENT,1182,1709,45,389617,94%
3330,MLB-MEMORY_CARD_READERS,127,216,45,389662,94%
4633,MLB-TATTOO_KITS,132,531,45,389707,94%
4894,MLB-REFRIGERATORS_AND_FREEZERS_SHELVES,281,687,45,389752,94%
5768,MLB-MARTIAL_ARTS_AND_BOXING_KICKING_SHIELDS,37,149,45,389797,94%
32,MLM-TOOLS,1593,2394,44,389841,94%
33,MLM-BABY_SUPPLIES,826,1114,44,389885,94%
132,MLM-DOG_SUPPLEMENTS,129,257,44,389929,94%
191,MLM-AUTOMOTIVE_HEADLIGHTS,882,1327,44,389973,94%
1870,MLB-MUSICAL_INSTRUMENTS,2686,3937,44,390017,94%
2210,MLB-DENTAL_PROSTHESES,211,855,44,390061,94%
2417,MLB-DESKTOP_COMPUTER_CASES,1005,2393,44,390105,94%
2665,MLB-PRESSURE_GAUGES,620,861,44,390149,94%
3303,MLB-ELECTRICAL_OUTLETS,548,1051,44,390193,94%
4423,MLB-ROBES,291,689,44,390237,94%
5590,MLB-POOL_MAINTENANCE_KITS,166,406,44,390281,94%
292,MLM-MICRO_ROTARY_TOOLS,117,326,43,390324,94%
2007,MLB-RINGS,2534,4628,43,390367,94%
2893,MLB-MOTORCYCLE_CRASH_BARS,1458,2891,43,390410,94%
3114,MLB-MASCARAS,366,662,43,390453,95%
3271,MLB-ANGLE_FINDERS,49,225,43,390496,95%
3610,MLB-COMBS,223,523,43,390539,95%
4495,MLB-BICYCLE_WALL_MOUNT_RACKS,91,328,43,390582,95%
4980,MLB-MICROCONTROLLERS,181,378,43,390625,95%
5594,MLB-REMOTE_CONTROL_HOLDERS,49,130,43,390668,95%
141,MLM-FANS,277,626,42,390710,95%
537,MLM-TACTICAL_AND_SPORTING_KNIVES_AND_BLADES,587,1318,42,390752,95%
545,MLM-COMBINED_TOOL_SETS,103,543,42,390794,95%
738,MLM-CYCLING_HELMETS,165,345,42,390836,95%
1466,MLM-MOTORCYCLE_COVERS,56,174,42,390878,95%
2793,MLB-DIGITAL_PORTABLE_MEDIA_PLAYERS,417,1032,42,390920,95%
3717,MLB-MOTORCYCLE_CASES,480,1222,42,390962,95%
3879,MLB-CONCERTINA_WIRES,99,407,42,391004,95%
5127,MLB-POOL_CHLORINE,183,546,42,391046,95%
5438,MLB-CAR_AIR_FRESHENERS,297,626,42,391088,95%
6596,MLB-REFRIGERATOR_AND_FREEZER_COMPRESSORS,193,346,42,391130,95%
37,MLM-DOLLS,928,1300,41,391171,95%
306,MLM-CELLPHONE_AND_TABLET_CASES,552,874,41,391212,95%
3034,MLB-CATS_AND_DOGS_FOODS,850,1148,41,391253,95%
3584,MLB-CUE_STICKS,162,573,41,391294,95%
3696,MLB-DEPILATORY_CREAMS,219,487,41,391335,95%
3820,MLB-AUTOMOTIVE_STEREO_FRAME_ADAPTERS,846,1319,41,391376,95%
4260,MLB-CAMPING_STOVES,396,924,41,391417,95%
4328,MLB-POLY_MAILERS,157,196,41,391458,95%
4628,MLB-KINESIOLOGY_TAPES,66,215,41,391499,95%
5008,MLB-STEAM_CLEANERS,196,410,41,391540,95%
27,MLM-TABLETS,831,1703,40,391580,95%
136,MLM-MALE_UNDERWEAR,562,1322,40,391620,95%
2911,MLB-DRILL_STANDS,220,545,40,391660,95%
3213,MLB-WIRELESS_CHARGERS,433,1001,40,391700,95%
3246,MLB-OVENS,725,2275,40,391740,95%
3474,MLB-DECORATIVE_BOXES,486,1484,40,391780,95%
3601,MLB-MINI_PHOTO_STUDIOS,78,267,40,391820,95%
3864,MLB-CELLPHONE_CAMERA_REPLACEMENT_LENSES,402,641,40,391860,95%
4623,MLB-BOOKENDS,144,434,40,391900,95%
5164,MLB-ORTHOPEDIC_ANKLE_BRACES,160,367,40,391940,95%
5197,MLB-WATER_BOOSTER_PUMPS,190,396,40,391980,95%
5247,MLB-MICRONEEDLING_CARTRIDGES,116,333,40,392020,95%
5565,MLB-CLEANING_SPONGES,147,210,40,392060,95%
98,MLM-LIGHTERS,337,695,39,392099,95%
445,MLM-GLASSES_FRAMES,383,840,39,392138,95%
660,MLM-HAMMER_DRILLS,276,596,39,392177,95%
874,MLM-GPS,161,620,39,392216,95%
966,MLM-AIR_COMPRESSORS,189,555,39,392255,95%
1256,MLM-ELECTRIC_DRILLS,169,505,39,392294,95%
1539,MLB-MUSIC_ALBUMS,2414,2583,39,392333,95%
2155,MLB-NAIL_POLISH_SHELVES,196,866,39,392372,95%
2222,MLB-IRRIGATION_SPRINKLERS,264,537,39,392411,95%
2455,MLB-HORSE_SUPPLEMENTS,221,401,39,392450,95%
2860,MLB-POPCORN_MACHINES,207,642,39,392489,95%
3622,MLB-STYLING_CHAIRS,480,1670,39,392528,95%
3744,MLB-CAMPING_LANTERNS,168,352,39,392567,95%
4024,MLB-CAR_CARBURETORS,591,876,39,392606,95%
6396,MLB-PET_DRYERS,68,277,39,392645,95%
560,MLM-SKIN_CARE_KITS,89,219,38,392683,95%
659,MLM-DISPOSABLE_BABY_DIAPERS,256,673,38,392721,95%
2208,MLB-BEERS,511,968,38,392759,95%
3405,MLB-BINOCULARS,236,733,38,392797,95%
3542,MLB-CYCLING_COMPUTERS,349,801,38,392835,95%
3586,MLB-MANNEQUINS,298,642,38,392873,95%
3682,MLB-PNEUMATIC_STAPLERS,120,373,38,392911,95%
4659,MLB-FALSE_NAILS,436,1018,38,392949,95%
4733,MLB-FLOOR_LAMPS,246,427,38,392987,95%
5991,MLB-WATCH_BOXES,145,268,38,393025,95%
227,MLM-ANIMAL_CLIPPERS,71,227,37,393062,95%
333,MLM-BOARD_GAMES,567,806,37,393099,95%
371,MLM-HEADLAMPS,156,452,37,393136,95%
1195,MLM-PRESENTATION_REMOTES,27,110,37,393173,95%
2185,MLM-ELECTRIC_FACIAL_BRUSHES_AND_SPONGES,86,320,37,393210,95%
2367,MLB-AUTOMOTIVE_SIDE_VIEW_MIRRORS,1717,2253,37,393247,95%
2411,MLB-CARDS_AND_INVITATIONS,1047,1481,37,393284,95%
4416,MLB-BUTT_PLUGS,289,638,37,393321,95%
5957,MLB-CUTTING_MATS,139,259,37,393358,95%
109,MLM-STUFFED_TOYS,850,1180,36,393394,95%
348,MLM-PANTIES,572,1257,36,393430,95%
474,MLM-MICRODERMABRASION_MACHINES,166,491,36,393466,95%
1302,MLM-KINESIOLOGY_TAPES,81,240,36,393502,95%
2328,MLM-FITNESS_TRAMPOLINES,46,132,36,393538,95%
2494,MLB-MAKEUP_VANITIES,474,2260,36,393574,95%
2714,MLB-MOTORCYCLE_SPEEDOMETERS,1113,2060,36,393610,95%
2772,MLB-DECORATIVE_VASES,1218,2534,36,393646,95%
3023,MLB-DISHES_RACKS,495,1200,36,393682,95%
3087,MLB-MEN_SWIMWEAR,553,1557,36,393718,95%
3559,MLB-CUTICLE_REMOVERS,283,626,36,393754,95%
3860,MLB-BEDDING_SETS,735,1437,36,393790,95%
4069,MLB-CAR_WINDOW_SWITCHES,573,800,36,393826,95%
4106,MLB-PHOTO_ALBUMS,472,722,36,393862,95%
5455,MLB-STATIONARY_BICYCLES,254,950,36,393898,95%
5692,MLB-GYMNASTIC_HAND_GRIPS,73,191,36,393934,95%
5728,MLB-ELECTRIC_INSECT_RACKETS,72,186,36,393970,95%
6410,MLB-PHOTOGRAPHIC_INSTANT_FILMS,39,107,36,394006,95%
160,MLM-ELECTRIC_PRESSURE_WASHERS,164,513,35,394041,95%
185,MLM-GREEN_WALLS_AND_LIVING_PAINTINGS,100,260,35,394076,95%
199,MLM-CALCULATORS,128,338,35,394111,95%
212,MLM-SPORT_SHORTS,277,760,35,394146,95%
366,MLM-DESIGN_AND_MULTIMEDIA_SOFTWARE,242,318,35,394181,95%
649,MLM-COMBUSTION_CHAINSAWS,131,408,35,394216,95%
1541,MLB-LAMINATING_ROLLS_AND_POUCHES,82,216,35,394251,95%
2049,MLB-COMBUSTION_BRUSH_CUTTERS_AND_STRING_TRIMMERS,226,714,35,394286,95%
2501,MLB-SHADE_CLOTHS,199,496,35,394321,95%
2511,MLB-SCHOOL_AND_OFFICE_SUPPLIES,737,938,35,394356,95%
2790,MLB-STAGE_LASER_LIGHTS,277,669,35,394391,95%
2908,MLB-MATTRESSES,632,1776,35,394426,95%
4096,MLB-ELECTRIC_MASSAGES_MATS,276,949,35,394461,95%
4355,MLB-ARTIFICIAL_PLANTS,311,942,35,394496,95%
4368,MLB-CLEANING_CLOTHS,379,685,35,394531,95%
4666,MLB-TOY_PRETEND_SUITCASES,263,633,35,394566,95%
5608,MLB-DOG_SUPPLEMENTS,240,341,35,394601,96%
100,MLM-SPORTS_AND_FITNESS,1302,1671,34,394635,96%
407,MLM-FOOTBALL_GOALKEEPER_GLOVES,234,591,34,394669,96%
895,MLM-STATIONARY_BICYCLES,101,393,34,394703,96%
2122,MLB-HOME_MANUAL_KNIFE_SHARPENERS,207,460,34,394737,96%
2221,MLB-AUTOMOTIVE_SPARE_TIRE_COVERS,270,443,34,394771,96%
2778,MLB-COFFEE_POD_HOLDERS,213,394,34,394805,96%
2829,MLB-AUTOMOTIVE_SUN_SHADES,177,368,34,394839,96%
3072,MLB-KNITTING_NEEDLES,149,369,34,394873,96%
3302,MLB-SHOE_RACKS,418,1321,34,394907,96%
3497,MLB-VIDEO_CAPTURE_DEVICES,251,370,34,394941,96%
3751,MLB-FRYING_PANS_WOKS_GRIDDLES_AND_GRILL_PANS,733,1441,34,394975,96%
4160,MLB-INTEGRATED_CIRCUITS,694,1002,34,395009,96%
5009,MLB-KIDS_TABLES_AND_CHAIRS_SETS,183,711,34,395043,96%
5146,MLB-MAGNETIC_WELDING_HOLDERS,107,315,34,395077,96%
5412,MLB-BABY_HIGH_CHAIRS,367,769,34,395111,96%
6294,MLB-PRINTER_RIBBONS,25,45,34,395145,96%
90,MLM-ELECTRONIC_PRODUCTS,1622,2352,33,395178,96%
484,MLM-STUN_GUNS,162,530,33,395211,96%
882,MLM-KITCHEN_COOKWARE_SETS,278,785,33,395244,96%
884,MLM-JEWELRY_BOXES,97,259,33,395277,96%
953,MLM-ELECTRIC_SHOWER_HEADS,67,275,33,395310,96%
1512,MLM-BIRD_EGGS_INCUBATORS,61,245,33,395343,96%
1749,MLB-ALARM_CLOCKS,226,467,33,395376,96%
2009,MLB-TACTICAL_VESTS,440,1354,33,395409,96%
2021,MLB-PERFORMANCE_SUSPENSION_KITS,699,1493,33,395442,96%
2092,MLB-AUTOMOTIVE_MUFFLERS,864,1422,33,395475,96%
2415,MLB-ANTIQUES,1628,1927,33,395508,96%
2844,MLB-CAR_ANTENNAS,662,984,33,395541,96%
3814,MLB-PET_BOWS,285,598,33,395574,96%
4213,MLB-TOILET_SEATS,518,894,33,395607,96%
4677,MLB-VIDEO_GAME_CONTROLLER_CHARGERS,127,236,33,395640,96%
5097,MLB-CAKES,127,245,33,395673,96%
273,MLM-VIDEO_CAMERAS,386,1186,32,395705,96%
290,MLM-COMMERCIAL_SOFTWARE,141,182,32,395737,96%
319,MLM-NAIL_POLISH,451,1023,32,395769,96%
479,MLM-VIOLINS,133,388,32,395801,96%
583,MLM-PUZZLE_CUBES,214,435,32,395833,96%
2394,MLB-MOTORCYCLE_LEVERS,594,1030,32,395865,96%
2418,MLB-VEHICLE_SCRATCH_REMOVERS,306,646,32,395897,96%
2710,MLB-BALLOONS_GRIDS,137,610,32,395929,96%
3423,MLB-JEWELRY,647,1434,32,395961,96%
4556,MLB-CO2_TANKS,138,364,32,395993,96%
4691,MLB-BASKETBALL_BACKBOARDS_AND_HOOPS,162,367,32,396025,96%
6523,MLB-BODY_FAT_CALIPERS,102,267,32,396057,96%
224,MLM-ELECTRONIC_ACCESSORIES_AND_SPARE_PARTS,640,1000,31,396088,96%
322,MLM-FALSE_EYELASHES,135,387,31,396119,96%
328,MLM-TRADING_CARD_GAMES,633,933,31,396150,96%
394,MLM-HOME_APPLIANCES_ACCESSORIES_AND_SPARE_PARTS,376,494,31,396181,96%
734,MLM-3D_PRINTER_FILAMENTS,59,160,31,396212,96%
1202,MLM-PLUNGE_ROUTERS,119,354,31,396243,96%
1455,MLM-PAINT_MACHINES,63,176,31,396274,96%
2218,MLB-MEAT_GRINDERS,289,634,31,396305,96%
2661,MLB-VEHICLE_STICKERS,2162,2989,31,396336,96%
2719,MLB-DRINKING_GLASSES,1683,2703,31,396367,96%
2783,MLB-FISHING_LINES,582,965,31,396398,96%
3027,MLB-SCREEN_PRINTERS,354,1120,31,396429,96%
3064,MLB-SOLDERING_STATIONS,249,583,31,396460,96%
3606,MLB-NIGHTGOWNS,500,1181,31,396491,96%
3936,MLB-TOY_ROBOTS,312,629,31,396522,96%
4169,MLB-MAKEUP_ORGANIZERS,251,652,31,396553,96%
4487,MLB-TOWEL_HOLDERS,258,487,31,396584,96%
4538,MLB-MOTORCYCLE_CHEST_PROTECTORS,196,396,31,396615,96%
4690,MLB-CD_AND_DVD_PLAYERS,255,490,31,396646,96%
5317,MLB-INDUSTRIAL_EXHAUST_FANS,62,172,31,396677,96%
276,MLM-DIGITAL_PORTABLE_MEDIA_PLAYERS,275,642,30,396707,96%
717,MLM-EXTERNAL_LAPTOP_COOLERS,89,299,30,396737,96%
844,MLM-WATER_HEATERS,162,392,30,396767,96%
848,MLM-TABLET_CASES,375,658,30,396797,96%
890,MLM-ELECTRIC_SCREWDRIVERS,63,234,30,396827,96%
1960,MLB-CONSTRUCTION_MATERIALS,718,1154,30,396857,96%
2044,MLB-PUREBRED_DOGS,2563,4201,30,396887,96%
2912,MLB-AUTOMOTIVE_IGNITION_COILS,677,751,30,396917,96%
3207,MLB-AUTOMOTIVE_EMBLEMS,1728,2106,30,396947,96%
3331,MLB-BABY_BLANKETS,534,1141,30,396977,96%
3582,MLB-EYEBROW_LINERS,300,615,30,397007,96%
3981,MLB-SHOWER_CADDIES,407,782,30,397037,96%
4028,MLB-TOOTHBRUSHES,386,641,30,397067,96%
4032,MLB-ELECTRIC_FOOD_STEAMERS,93,290,30,397097,96%
4078,MLB-CAT_SCRATCHERS,194,602,30,397127,96%
4469,MLB-BICYCLE_TOOL_KITS,126,366,30,397157,96%
4615,MLB-DIGITAL_VOICE_RECORDERS,119,214,30,397187,96%
4877,MLB-DOG_GROOMING_SCISSORS,104,349,30,397217,96%
311,MLM-PORTABLE_ELECTRIC_MASSAGERS,167,306,29,397246,96%
361,MLM-BABY_BODYSUITS,366,703,29,397275,96%
459,MLM-ARTS_AND_CRAFTS,1030,1227,29,397304,96%
482,MLM-COMPUTER_MONITORS,329,767,29,397333,96%
615,MLM-GRAPHICS_TABLETS,113,338,29,397362,96%
1035,MLM-CAMERA_TRIPODS,101,217,29,397391,96%
1203,MLM-BUTT_PLUGS,123,297,29,397420,96%
1390,MLM-GYM_DUMBBELLS,106,337,29,397449,96%
1430,MLM-CELLPHONE_CAMERA_ATTACHMENTS,97,222,29,397478,96%
2481,MLB-COOKIES_CUTTERS,299,404,29,397507,96%
2521,MLB-CELLPHONE_AND_TABLET_CASES,1011,1459,29,397536,96%
2655,MLB-SPARK_PLUG_WIRESETS,846,1115,29,397565,96%
2663,MLB-PET_TOOTHPASTES,131,208,29,397594,96%
2742,MLB-MICRO_ROTARY_TOOL_KITS,300,622,29,397623,96%
2956,MLB-DVR_RECORDERS,201,400,29,397652,96%
3801,MLB-PENCIL_CASES,491,1088,29,397681,96%
4477,MLB-CRIMPING_PLIERS,204,407,29,397710,96%
5588,MLB-STRAIGHT_RAZORS,218,443,29,397739,96%
6267,MLB-COMMERCIAL_LIGHT_SIGNS,129,346,29,397768,96%
6459,MLB-BABY_FEEDING_PACIFIERS,76,231,29,397797,96%
223,MLM-HAIR_STRAIGHTENERS,348,682,28,397825,96%
416,MLM-MOUSE_PADS,181,450,28,397853,96%
526,MLM-GAME_CONSOLE_CASES_AND_BAGS,161,445,28,397881,96%
688,MLM-UKULELES,104,187,28,397909,96%
1056,MLM-BABY_BATHTUBS,95,210,28,397937,96%
1371,MLM-WATER_BOOSTER_PUMPS,65,278,28,397965,96%
2520,MLB-GAS_GRILLS,296,620,28,397993,96%
2900,MLB-PANTYHOSE,419,744,28,398021,96%
3075,MLB-SKIN_CARE_KITS,392,879,28,398049,96%
3186,MLB-FACE_POWDERS,358,621,28,398077,96%
3479,MLB-FOOSBALL_TABLES,142,342,28,398105,96%
3553,MLB-PHOTO_STUDIO_KITS,62,151,28,398133,96%
3576,MLB-BABY_PLAYARDS,357,963,28,398161,96%
4183,MLB-VOLLEYBALL_BALLS,163,276,28,398189,96%
4437,MLB-SIDEBOARDS,594,1702,28,398217,96%
4523,MLB-DRILL_ADAPTERS,110,286,28,398245,96%
4610,MLB-BICYCLE_SHIFTERS,338,668,28,398273,96%
4876,MLB-TABLE_CLOCKS,193,428,28,398301,96%
5679,MLB-OPTICAL_INSTRUMENTS,84,178,28,398329,96%
77,MLM-SCHOOL_AND_OFFICE_SUPPLIES,652,789,27,398356,96%
129,MLM-STYLING_CHAIRS,107,250,27,398383,96%
161,MLM-MASSAGE_EQUIPMENT,157,320,27,398410,96%
767,MLM-JEWELRY_TOOLS,170,302,27,398437,96%
991,MLM-COMMERCIAL_AND_EVENT_BAGS,270,533,27,398464,96%
1074,MLM-EYELINERS,181,376,27,398491,96%
1239,MLM-INSECT_KILLER_LIGHTS,22,99,27,398518,96%
2036,MLB-GLASS_CUTTERS,53,155,27,398545,96%
2214,MLB-DESKTOP_COMPUTERS,2395,5967,27,398572,96%
2419,MLB-BALL_PIT_BALLS,203,612,27,398599,96%
2886,MLB-ROOF_RACKS,1229,1670,27,398626,96%
3162,MLB-CONCEALERS,360,756,27,398653,96%
3234,MLB-PHOTOGRAPHY_BACKDROP_STANDS,86,294,27,398680,96%
3298,MLB-CELLPHONE_AND_TABLET_FLEX_CABLES,451,574,27,398707,97%
3785,MLB-CHAFING_DISHES,196,505,27,398734,97%
4345,MLB-ESSENTIAL_OILS,288,640,27,398761,97%
4351,MLB-METAL_DETECTORS,202,753,27,398788,97%
4426,MLB-ELECTRONIC_DRUMS,266,566,27,398815,97%
5812,MLB-UNDERPLATES,70,196,27,398842,97%
113,MLM-MANICURE_AND_PEDICURE_SUPPLIES,455,793,26,398868,97%
198,MLM-FASHION_ACCESSORIES,658,796,26,398894,97%
379,MLM-HOME_OFFICE_DESKS,328,951,26,398920,97%
438,MLM-BABY_PLAYARDS,144,284,26,398946,97%
622,MLM-LAPTOP_KEYBOARDS,181,236,26,398972,97%
712,MLM-SEWING_MACHINES,240,397,26,398998,97%
780,MLM-RABBIT_AND_RODENT_CAGES,115,393,26,399024,97%
1015,MLM-TEETH_WHITENING_PRODUCTS,61,167,26,399050,97%
1208,MLM-BABY_CUSHIONS_AND_PILLOWS,76,151,26,399076,97%
2051,MLB-MOTORCYCLE_TRANSMISSION_KITS,1158,1760,26,399102,97%
2224,MLB-ELECTRIC_SHOWER_HEADS,368,803,26,399128,97%
2354,MLB-PIERCINGS,956,1723,26,399154,97%
2771,MLB-TOOL_BOXES,672,1782,26,399180,97%
3110,MLB-PICTURE_FRAMES,491,788,26,399206,97%
3422,MLB-LEARNING_TOY_LAPTOPS,191,642,26,399232,97%
3857,MLB-FABRIC_WATER_REPELLENT_PRODUCTS,136,265,26,399258,97%
3920,MLB-BABY_BATHTUBS,353,914,26,399284,97%
4000,MLB-KIDS_WRIST_LEASHES,50,158,26,399310,97%
4258,MLB-AUDIO_AND_VIDEO_CONNECTORS,739,1019,26,399336,97%
5456,MLB-KITCHEN_SIEVES,178,273,26,399362,97%
147,MLM-CELLPHONE_PARTS,228,307,25,399387,97%
165,MLM-IDENTIFICATION_AND_PRESENTATION_CARDS,102,125,25,399412,97%
356,MLM-BEAUTY_WIGS,384,772,25,399437,97%
426,MLM-SOCKS,448,782,25,399462,97%
492,MLM-RAM_MEMORY_MODULES,340,603,25,399487,97%
522,MLM-INDOOR_CURTAINS_AND_BLINDS,317,663,25,399512,97%
612,MLM-DESKTOP_COMPUTER_POWER_SUPPLIES,143,279,25,399537,97%
1646,MLM-REFLECTIVE_VESTS,65,200,25,399562,97%
1974,MLB-COMFORTERS,798,2263,25,399587,97%
2106,MLB-CYCLING_JERSEYS,419,769,25,399612,97%
2337,MLB-BASEBALL_AND_SOFTBALL_BATS,108,349,25,399637,97%
2441,MLB-CRIBS,360,1142,25,399662,97%
2683,MLB-BOOKS_MAGAZINES_AND_COMICS,1036,1233,25,399687,97%
2731,MLB-CAMERA_AND_CELLPHONE_STABILIZERS,342,688,25,399712,97%
2950,MLM-AUDIO_AND_VIDEO_CONVERTERS,26,136,25,399737,97%
3629,MLB-GUN_HOLSTERS,524,921,25,399762,97%
3752,MLB-WATER_TANKS,174,442,25,399787,97%
3818,MLB-MOTORCYCLE_STANDS,346,582,25,399812,97%
3977,MLB-PHOTOGRAPHIC_DIFFUSERS,190,370,25,399837,97%
4130,MLB-SELF_ADHESIVE_LABELS,526,894,25,399862,97%
4340,MLB-MOTORCYCLE_HANDLEBARS,571,930,25,399887,97%
4580,MLB-MUSIC_STANDS,73,194,25,399912,97%
4762,MLB-TILE_LEVELER_SPACERS,168,352,25,399937,97%
4776,MLB-UNIVERSAL_HOME_GYMS,145,792,25,399962,97%
5155,MLB-WATER_DISPENSER_TAPS,131,196,25,399987,97%
6062,MLB-ACTION_CAMERA_ACCESSORIES_KITS,85,259,25,400012,97%
6401,MLB-BABY_CORNER_GUARDS,100,219,25,400037,97%
215,MLM-AUTOMOTIVE_AMPLIFIERS,325,568,24,400061,97%
314,MLM-SANDALS_AND_FLIP_FLOPS,899,1368,24,400085,97%
404,MLM-HAIR_EXTENSIONS,191,378,24,400109,97%
624,MLM-BED_SHEETS,200,531,24,400133,97%
796,MLM-ORTHOTICS,87,203,24,400157,97%
976,MLM-CHARMS_AND_MEDALS,572,762,24,400181,97%
1294,MLM-MOTORCYCLE_RAIN_SUITS,90,396,24,400205,97%
1589,MLM-CORSETS,81,245,24,400229,97%
1763,MLB-FREEZERS,820,1945,24,400253,97%
2086,MLB-COMPUTER_PROCESSORS,1595,3088,24,400277,97%
3198,MLB-DRAWERS,602,2001,24,400301,97%
3805,MLB-TOILET_RUGS,522,1174,24,400325,97%
3886,MLB-BABY_BATH_FLOATING_PILLOWS,76,151,24,400349,97%
4350,MLB-SOUND_CARDS,181,350,24,400373,97%
4686,MLB-CELLPHONE_SIGNAL_BOOSTER_ANTENNAS,173,438,24,400397,97%
4747,MLB-WATER_BEADS,40,115,24,400421,97%
4827,MLB-CAJONS,183,420,24,400445,97%
4847,MLB-CALENDARS,138,247,24,400469,97%
5023,MLB-SPORTS_CONES,72,203,24,400493,97%
5386,MLB-BLENDER_BLADES,122,170,24,400517,97%
5429,MLB-SODS,44,68,24,400541,97%
6045,MLB-SWIMMING_EARPLUGS,57,106,24,400565,97%
6168,MLB-FINGER_SKATEBOARDS,45,154,24,400589,97%
573,MLM-SMART_SPEAKERS,96,198,23,400612,97%
705,MLM-DINING_CHAIRS,178,415,23,400635,97%
877,MLM-BEARD_OILS_AND_BALMS,87,315,23,400658,97%
1721,MLB-PARTY_FAVOR_BRACELETS_AND_NECKLACES,112,212,23,400681,97%
2712,MLB-HEADPIECES_TIARAS_AND_HEADBANDS,761,1275,23,400704,97%
2825,MLB-KEY_RACKS,326,493,23,400727,97%
3917,MLB-VASES,610,1250,23,400750,97%
4003,MLB-WATER_HEATERS,342,644,23,400773,97%
4247,MLB-CAMERA_BATTERIES,350,478,23,400796,97%
4393,MLB-MAGNETIC_GLASS_CLEANERS,38,118,23,400819,97%
4561,MLB-MOTORCYCLE_SEATS,159,268,23,400842,97%
5182,MLB-BABY_BOTTLE_NIPPLES,117,163,23,400865,97%
5319,MLB-IRRIGATION_VALVES,62,122,23,400888,97%
5552,MLB-SYRINGES,83,157,23,400911,97%
5913,MLB-ORTHOPEDIC_WALKER_BOOTS,70,189,23,400934,97%
277,MLM-PROJECTORS,303,704,22,400956,97%
631,MLM-NETWORK_CARDS,125,203,22,400978,97%
694,MLM-TACTICAL_BELTS,70,292,22,401000,97%
696,MLM-EPILATORS_AND_TRIMMERS,113,257,22,401022,97%
774,MLM-HEELS_AND_WEDGES,539,791,22,401044,97%
867,MLM-WHEELCHAIRS,76,195,22,401066,97%
945,MLM-MAGNIFYING_GLASSES,84,147,22,401088,97%
1277,MLM-KITCHEN_THERMOMETERS,75,136,22,401110,97%
1313,MLM-TEMPORARY_TATTOOS,91,142,22,401132,97%
1468,MLM-DVD_RECORDERS,52,100,22,401154,97%
2170,MLM-CENTRIFUGAL_PUMPS,50,129,22,401176,97%
2359,MLB-TOILET_PAPER_HOLDERS,353,677,22,401198,97%
2430,MLB-NECKTIES,434,841,22,401220,97%
3597,MLB-ELECTRIC_HOISTS,103,283,22,401242,97%
4307,MLB-GINS,121,339,22,401264,97%
4511,MLB-TABLECLOTHS,763,1085,22,401286,97%
4539,MLB-SELF_DEFENSE_TELESCOPIC_BATONS,97,222,22,401308,97%
5238,MLB-TRAINING_BIBS,88,234,22,401330,97%
5306,MLB-MANUAL_HOISTS,54,134,22,401352,97%
6253,MLB-NASAL_WASHERS,39,99,22,401374,97%
6307,MLB-CUPCAKES_MAKERS,31,118,22,401396,97%
69,MLM-EPILATORS,48,131,21,401417,97%
732,MLM-DOG_CARRIERS_AND_CARRYING_BAGS,110,209,21,401438,97%
853,MLM-STRAIGHT_RAZORS,64,119,21,401459,97%
869,MLM-DOG_HOUSES,124,208,21,401480,97%
1067,MLM-MALE_MASTURBATORS,212,444,21,401501,97%
1279,MLM-LASER_POINTERS,100,270,21,401522,97%
1549,MLM-RADIO_FREQUENCY_MACHINES,60,231,21,401543,97%
1620,MLM-PAINT_ROLLERS,40,131,21,401564,97%
1813,MLM-MICRONEEDLING_CARTRIDGES,40,89,21,401585,97%
2363,MLB-FAKE_CAKES,437,565,21,401606,97%
2718,MLM-MELODICAS,34,87,21,401627,97%
2782,MLB-COCKTAIL_SHAKERS,81,184,21,401648,97%
2815,MLB-DENTAL_HIGH_SPEED_HANDPIECES,98,175,21,401669,97%
3001,MLB-SPORT_BRAS,273,713,21,401690,97%
3279,MLB-MOTORCYCLE_BLOCK_CYLINDERS,931,1421,21,401711,97%
3596,MLB-STETHOSCOPES,212,536,21,401732,97%
3602,MLB-BABY_PACIFIERS,530,922,21,401753,97%
3638,MLB-NETWORK_SWITCHES,376,488,21,401774,97%
4084,MLB-PAINTBALL_MASKS,293,490,21,401795,97%
4515,MLB-PLAYGROUND_SWING_SETS,189,426,21,401816,97%
4558,MLB-DEFENSE_KNUCKLES,102,202,21,401837,97%
5126,MLB-CAMERA_MONOPODS,221,443,21,401858,97%
5161,MLB-MANUAL_HAMMERS,175,335,21,401879,97%
5206,MLB-HAND_WINCHES,83,196,21,401900,97%
5289,MLB-PENCILS,307,488,21,401921,97%
6259,MLB-TOY_GARAGES_AND_GAS_STATIONS,103,410,21,401942,97%
7351,MLB-PANTY_LINERS,6,60,21,401963,97%
81,MLM-BALLOONS,430,803,20,401983,97%
351,MLM-BELTS,306,496,20,402003,97%
495,MLM-BICYCLE_ACCESSORIES_AND_SPARE_PARTS,511,784,20,402023,97%
729,MLM-SLATWALL_PANEL_SUPPORTS,58,137,20,402043,97%
766,MLM-TOOL_NOZZLES,169,420,20,402063,97%
1170,MLM-DISPOSABLE_GLOVES,93,145,20,402083,97%
1293,MLM-GAZEBOS,37,51,20,402103,97%
1934,MLM-CRAYONS,72,243,20,402123,97%
1964,MLB-ELECTRICAL_SUPPLIES,1233,1746,20,402143,97%
2252,MLM-HEAT_GUNS,75,148,20,402163,97%
3077,MLB-COMICS,633,734,20,402183,97%
3415,MLB-STEP_PLATFORMS,78,214,20,402203,97%
3627,MLB-SOLAR_PANELS,603,2393,20,402223,97%
3645,MLB-LED_CHIPS,426,556,20,402243,97%
4310,MLB-AUTOMOTIVE_LED_LIGHT_BARS,285,651,20,402263,97%
4604,MLB-TEXTILE_ELASTICS,86,225,20,402283,97%
4784,MLB-UMBRELLAS,310,582,20,402303,97%
5159,MLB-SMARTWATCH_CHARGERS,61,176,20,402323,97%
5752,MLB-BEARD_KITS,161,297,20,402343,97%
5914,MLB-ARM_SLINGS,22,57,20,402363,97%
6420,MLB-ANKLE_AND_WRIST_WEIGHTS,111,387,20,402383,97%
6758,MLB-HARMONICAS,130,176,20,402403,97%
181,MLM-PHOTOGRAPHY_ACCESSORIES_AND_SPARE_PARTS,366,515,19,402422,97%
326,MLM-SAFETY_FOOTWEAR,291,575,19,402441,97%
454,MLM-POTTIES,78,229,19,402460,97%
893,MLM-VINYL_ROLLS,150,381,19,402479,97%
1073,MLM-XENON_KITS,133,340,19,402498,97%
1698,MLM-KITCHEN_APRONS,45,114,19,402517,97%
2347,MLB-AUTOMOTIVE_TIMING_BELTS,864,1063,19,402536,97%
2435,MLB-NAIL_RHINESTONES,329,885,19,402555,97%
2641,MLB-ELECTRIC_SAWS,302,846,19,402574,97%
2873,MLB-SEX_TOYS_AND_SUPPLIES,375,641,19,402593,97%
2975,MLB-PENIS_SLEEVES,261,652,19,402612,97%
3134,MLB-HOME_REPELLENTS,271,459,19,402631,97%
3641,MLB-TAB_GRABBERS,26,52,19,402650,97%
3809,MLB-MANUAL_PAPER_CUTTERS,107,235,19,402669,97%
4568,MLB-NAUTICAL_PARTS,337,507,19,402688,97%
4578,MLB-DILDOS,309,599,19,402707,97%
4608,MLB-BABY_TEETHERS,225,385,19,402726,97%
4673,MLB-BREAD_MAKERS,70,157,19,402745,97%
5606,MLB-ACUPUNCTURE_NEEDLES,82,147,19,402764,97%
5648,MLB-COMPUTER_AND_TV_FLEX_CABLES,252,266,19,402783,97%
6081,MLB-AUDIO_INTERFACES,318,530,19,402802,97%
6363,MLB-HEARING_PROTECTORS,83,138,19,402821,97%
6589,MLB-TOY_BUBBLE_BLOWERS,104,227,19,402840,98%
203,MLM-KITCHEN_POTS,128,275,18,402858,98%
645,MLM-MATTRESS_COVERS,104,238,18,402876,98%
773,MLM-BREAST_MILK_STORAGE_BAGS,51,137,18,402894,98%
826,MLM-TACTICAL_VESTS,114,364,18,402912,98%
1077,MLM-TV_RECEIVERS_AND_DECODERS,149,220,18,402930,98%
1366,MLM-PET_BRUSHES,86,176,18,402948,98%
1398,MLM-YOGA_MATS,64,162,18,402966,98%
1836,MLM-ACTION_CAMERA_ACCESSORIES_KITS,26,106,18,402984,98%
1850,MLB-ABS_SENSORS,164,176,18,403002,98%
2061,MLM-AEROBIC_CRUNCH_MACHINES,58,130,18,403020,98%
2334,MLB-BABYDOLLS,297,903,18,403038,98%
2724,MLB-BICYCLE_COMBUSTION_ENGINE_KITS,34,175,18,403056,98%
3093,MLB-ELECTRONIC_MUSCLE_STIMULATORS,98,230,18,403074,98%
3545,MLB-MANIFOLD_GAUGE_SETS,149,237,18,403092,98%
3642,MLB-SWEATERS_AND_CARDIGANS,447,992,18,403110,98%
3783,MLB-EDIBLE_SEEDS,152,340,18,403128,98%
4017,MLB-SPORT_PANTS,227,490,18,403146,98%
4170,MLB-DOG_LEASHES,263,518,18,403164,98%
4272,MLB-SAFETY_GOGGLES,134,209,18,403182,98%
4404,MLB-STRING_INSTRUMENT_EFFECTS_PEDALS,575,743,18,403200,98%
4412,MLB-BAR_CLAMPS,306,468,18,403218,98%
4544,MLB-BATH_SALTS,157,230,18,403236,98%
4591,MLB-WOOD_BURNING_MACHINES,91,177,18,403254,98%
4622,MLB-AUTOMOTIVE_COMPRESSION_DRIVERS,663,1414,18,403272,98%
5082,MLB-TEA,201,343,18,403290,98%
5125,MLB-INFLATABLE_SOFAS,83,310,18,403308,98%
5454,MLB-STEPPERS,87,273,18,403326,98%
5634,MLB-UPS_BATTERIES,150,220,18,403344,98%
5675,MLB-BUBBLE_MACHINES,48,111,18,403362,98%
5821,MLB-FOOT_BATH_MASSAGERS,43,164,18,403380,98%
6029,MLB-BUTANE_GAS_CARTRIDGES,48,113,18,403398,98%
6371,MLB-TENNIS_BALLS,40,57,18,403416,98%
6888,MLB-CELLPHONE_FANS,25,85,18,403434,98%
135,MLM-FOOTBALL_SHOES,891,1308,17,403451,98%
282,MLM-SANDER_MACHINES,103,226,17,403468,98%
296,MLM-BAR_CODE_SCANNERS,86,178,17,403485,98%
609,MLM-CHINESE_MEDICAL_CUPS_SETS,55,157,17,403502,98%
674,MLM-CELLPHONE_AND_TABLET_FLEX_CABLES,306,449,17,403519,98%
722,MLM-SPORT_T_SHIRTS,379,721,17,403536,98%
772,MLM-VEHICLE_CAMERAS,146,381,17,403553,98%
909,MLM-INSTANT_NOODLES,63,195,17,403570,98%
1245,MLM-CAR_ANTENNAS,162,294,17,403587,98%
1336,MLM-TOY_SEWING_MACHINES,18,76,17,403604,98%
2019,MLB-AUTOMOTIVE_DEFLECTORS,1005,1445,17,403621,98%
2343,MLB-MARKING_AND_WARNING_TAPES,257,397,17,403638,98%
2682,MLB-DECORATIVE_BASKETS,630,1212,17,403655,98%
2816,MLB-AUTOMOTIVE_FILTER_KITS,636,832,17,403672,98%
3033,MLB-ELECTRONIC_SWITCHES,224,325,17,403689,98%
3097,MLB-MOTORCYCLE_FAIRINGS,2113,3103,17,403706,98%
3768,MLM-LAMINATORS,33,79,17,403723,98%
4419,MLB-GUITAR_INTERFACES,38,118,17,403740,98%
4448,MLB-IMPACT_WRENCHES,238,548,17,403757,98%
4984,MLB-MONOCULARS,152,446,17,403774,98%
5048,MLB-PET_SEAT_BELTS,21,34,17,403791,98%
5122,MLB-CLOCKS_ACCESSORIES_AND_SPARE_PARTS,270,385,17,403808,98%
5166,MLB-STRING_INSTRUMENT_CAPOS,62,119,17,403825,98%
5915,MLB-WALL_AND_DOOR_EXERCISE_BARS,29,139,17,403842,98%
6247,MLB-SWEETENERS,82,126,17,403859,98%
111,MLM-PENS,345,515,16,403875,98%
289,MLM-VEHICLE_STICKERS,327,742,16,403891,98%
340,MLM-DEODORANTS,79,134,16,403907,98%
397,MLM-THERMOMETERS,47,78,16,403923,98%
451,MLM-BLANKETS,255,447,16,403939,98%
505,MLM-BREAST_FEEDING_PILLOWS,41,121,16,403955,98%
556,MLM-TREADMILLS,92,352,16,403971,98%
598,MLM-PARTY_PRINTABLE_KITS,180,248,16,403987,98%
817,MLM-TOY_NEODYMIUM_MAGNETS,58,122,16,404003,98%
962,MLM-LUNCHBOXES,260,702,16,404019,98%
988,MLM-FISH_TANK_HOODS,29,51,16,404035,98%
1059,MLM-CONTINUOUS_INK_SYSTEMS,85,239,16,404051,98%
1236,MLM-DOOR_AND_GATE_REMOTE_CONTROLS,38,66,16,404067,98%
1283,MLM-EYELASH_GLUES,62,127,16,404083,98%
1591,MLM-BEERS,91,169,16,404099,98%
2177,MLM-PILATES_BALLS,31,67,16,404115,98%
2254,MLM-POWER_SAVERS,65,134,16,404131,98%
2569,MLB-TV_SMPS,1075,1175,16,404147,98%
2774,MLB-MOTORCYCLE_HELMET_VISORS,446,704,16,404163,98%
2805,MLB-MAILBOXES,211,341,16,404179,98%
3401,MLB-PLAYING_CARDS,210,391,16,404195,98%
3406,MLB-SOUND_CONSOLES_AND_DJ_MIXERS,336,562,16,404211,98%
3458,MLB-WINES,459,576,16,404227,98%
3735,MLB-GUITAR_STRINGS,374,550,16,404243,98%
4277,MLB-BABY_BATH_THERMOMETERS,66,120,16,404259,98%
4410,MLB-LABEL_MAKER_TAPES,62,84,16,404275,98%
4464,MLB-PALLETS,96,219,16,404291,98%
4493,MLB-ROBOT_VACUUMS,213,631,16,404307,98%
4625,MLB-EYELINERS,292,465,16,404323,98%
4761,MLB-FOOTBALL_KITS,270,583,16,404339,98%
4816,MLM-DOUBLE_CHIN_REDUCER_DEVICES,17,30,16,404355,98%
4991,MLB-KITCHEN_MOLDS,517,889,16,404371,98%
5064,MLB-CAMERA_FLASHES,256,446,16,404387,98%
5101,MLB-LED_THERAPY_FACE_MASKS,54,105,16,404403,98%
5163,MLB-PET_PLAYPENS,89,279,16,404419,98%
5955,MLB-CORRECTIVE_CONTACT_LENSES,43,230,16,404435,98%
6287,MLB-DIGITAL_TEMPERATURE_CONTROLLERS,76,183,16,404451,98%
6611,MLB-WHEELBARROWS,45,168,16,404467,98%
6706,MLB-ALARM_REMOTE_CONTROLS,43,104,16,404483,98%
6724,MLB-BREADS,24,20,16,404499,98%
7055,MLB-ULTRASONIC_CLEANERS,12,30,16,404515,98%
7144,MLB-TRAINING_BATTLE_ROPES,85,164,16,404531,98%
7269,MLB-HANDLOOMS,22,22,16,404547,98%
173,MLM-EMPLOYEE_TIME_CLOCKS,51,137,15,404562,98%
206,MLM-EARRINGS,613,856,15,404577,98%
288,MLM-AUTOMOTIVE_LICENSE_PLATE_BRACKETS,172,245,15,404592,98%
399,MLM-MONEY_BOXES,133,206,15,404607,98%
447,MLM-PERSONAL_LUBRICANTS_AND_GELS,217,460,15,404622,98%
605,MLM-VEHICLE_BATTERY_CHARGERS,164,316,15,404637,98%
648,MLM-MULTIMETERS,234,467,15,404652,98%
813,MLM-BAR_SOAPS,88,163,15,404667,98%
908,MLM-TRAMPOLINES,77,212,15,404682,98%
1014,MLM-UMBRELLAS,123,232,15,404697,98%
1078,MLM-USB_HUBS,134,214,15,404712,98%
1154,MLM-SURFACES_PROTECTIVE_PAINTS,105,245,15,404727,98%
1224,MLM-COLOR_POWDERS,33,117,15,404742,98%
1251,MLM-DISHES_RACKS,103,330,15,404757,98%
1258,MLM-DOG_BEDS,155,358,15,404772,98%
1282,MLM-MANUAL_SCREWDRIVERS,191,305,15,404787,98%
1286,MLM-BABY_HIGH_CHAIRS,70,180,15,404802,98%
1338,MLM-INDUSTRIAL_AND_COMMERCIAL_BAG_SEALERS,83,174,15,404817,98%
1757,MLB-HAMBURGER_PRESSES,173,417,15,404832,98%
1772,MLM-OPERATING_SYSTEMS,90,118,15,404847,98%
1969,MLB-PLASTIC_MODEL_KITS,224,225,15,404862,98%
2038,MLB-TOOL_AND_CONSTRUCTION_SUPPLIES,1276,1789,15,404877,98%
2352,MLB-RUBBER_STAMPS,316,506,15,404892,98%
2355,MLB-PATIO_FURNITURE_SETS,435,955,15,404907,98%
2378,MLB-VOLTAGE_DETECTORS,155,372,15,404922,98%
2654,MLB-CAKE_SMOOTHERS,62,255,15,404937,98%
2869,MLB-HOME_LIGHTING_SUPPLIES,587,855,15,404952,98%
3180,MLM-PRINTER_SOFTWARE,24,53,15,404967,98%
3190,MLB-3D_PENS,34,74,15,404982,98%
3466,MLM-SALON_TROLLEYS,21,73,15,404997,98%
3587,MLB-HAIR_REMOVAL,246,457,15,405012,98%
3718,MLB-SLEEPING_BAGS,198,559,15,405027,98%
3806,MLB-TREADMILL_LUBRICANTS,7,22,15,405042,98%
3833,MLB-KITCHEN_SKIMMERS,121,238,15,405057,98%
3851,MLB-SCREWS,494,847,15,405072,98%
3919,MLB-AUTOMOTIVE_POWER_WINDOW_REGULATORS,1459,1880,15,405087,98%
3968,MLB-BOX_SPRING_AND_MATTRESS_SETS,641,2227,15,405102,98%
4038,MLB-MENSTRUAL_CUPS,86,275,15,405117,98%
4091,MLB-GAS_CYLINDER_COVERS,43,124,15,405132,98%
4173,MLB-WINDSHIELD_WASHER_FLUID_RESERVOIRS,196,228,15,405147,98%
4223,MLB-TIMERS,113,211,15,405162,98%
4304,MLB-THERMAL_SHIRTS,81,201,15,405177,98%
4445,MLB-ELECTRIC_WAFFLE_MAKERS,94,287,15,405192,98%
4680,MLB-AUTOMOTIVE_PET_SEAT_COVERS,30,98,15,405207,98%
4768,MLB-VARNISHES,137,366,15,405222,98%
4810,MLB-BLANK_DISCS,151,240,15,405237,98%
5181,MLB-CPU_HOLDERS,81,121,15,405252,98%
5198,MLB-THERMOMETERS,108,204,15,405267,98%
5300,MLB-STRAWS,167,290,15,405282,98%
5849,MLB-SEAT_BELTS,342,493,15,405297,98%
7305,MLB-HOME_CAN_CRUSHERS,22,47,15,405312,98%
150,MLM-SPHYGMOMANOMETERS,58,238,14,405326,98%
207,MLM-ALARMS_AND_SENSORS,291,510,14,405340,98%
231,MLM-SWEATERS_AND_CARDIGANS,374,623,14,405354,98%
317,MLM-ALARM_CLOCKS,96,282,14,405368,98%
330,MLM-HOME_THEATERS,250,424,14,405382,98%
600,MLM-VESTS,324,606,14,405396,98%
679,MLM-STAGE_LASER_LIGHTS,65,122,14,405410,98%
782,MLM-MOTORCYCLE_GOGGLES,91,150,14,405424,98%
783,MLM-GIFT_CARDS,62,109,14,405438,98%
863,MLM-GARDEN_SOIL,36,59,14,405452,98%
963,MLM-CLOGS_AND_MULES,149,219,14,405466,98%
970,MLM-CARPETS,214,361,14,405480,98%
977,MLM-MAKEUP_ORGANIZERS,65,177,14,405494,98%
1278,MLM-RING_SIZERS,7,41,14,405508,98%
1501,MLM-LABEL_MAKERS,56,125,14,405522,98%
1845,MLB-AUTOMOBILE_FUEL_PUMPS,911,1138,14,405536,98%
2158,MLB-BICYCLE_FORKS,488,940,14,405550,98%
2178,MLM-JUMP_ROPES,61,146,14,405564,98%
2244,MLB-BICYCLE_PEDALS,156,209,14,405578,98%
2297,MLB-CANDIES,701,1119,14,405592,98%
2473,MLB-VEHICLE_TOW_ROPES,121,249,14,405606,98%
2545,MLB-SWIMMING_GOGGLES,120,209,14,405620,98%
3120,MLB-CAVAQUINHOS,192,341,14,405634,98%
3194,MLB-MUSICAL_KEYBOARDS,779,1297,14,405648,98%
3745,MLB-BABY_CAR_MIRRORS,58,184,14,405662,98%
3804,MLB-DRIVING_SIMULATORS,114,345,14,405676,98%
3991,MLB-SIM_CARDS,108,163,14,405690,98%
4043,MLB-CUTTING_BOARDS,419,876,14,405704,98%
4256,MLB-HORSE_SADDLES,490,1088,14,405718,98%
4337,MLB-LAPTOP_LCD_SCREENS,533,578,14,405732,98%
4373,MLB-CONCRETE_VIBRATORS,35,86,14,405746,98%
4476,MLB-DOLLHOUSE_FURNITURE_AND_APPLIANCES,173,396,14,405760,98%
4600,MLB-PLANNERS_AND_PERSONAL_DIARIES,449,708,14,405774,98%
4871,MLB-MELODICAS,42,95,14,405788,98%
4919,MLB-JEWELRY_DISPLAYS,189,319,14,405802,98%
5297,MLB-PORTABLE_DVD_PLAYERS,97,178,14,405816,98%
5302,MLB-HYDRAULIC_CRIMPING_PLIERS,33,120,14,405830,98%
5398,MLB-PRUNING_SHEARS,54,82,14,405844,98%
5597,MLB-FACIAL_STEAMERS,171,432,14,405858,98%
5666,MLB-DRYER_MACHINES,155,327,14,405872,98%
5818,MLB-FISHING_VESTS,95,196,14,405886,98%
6079,MLB-GAME_CONSOLE_CASES_AND_BAGS,204,279,14,405900,98%
6424,MLB-PAINTBALL_REMOTES,28,94,14,405914,98%
6565,MLB-INCENSES,96,156,14,405928,98%
6887,MLB-DENTAL_CURING_LIGHTS,43,89,14,405942,98%
6989,MLB-LAMP_HOLDERS,40,173,14,405956,98%
54,MLM-KITCHEN_PLAYSETS,120,330,13,405969,98%
57,MLM-MOTORCYCLE_EMBLEMS,235,401,13,405982,98%
97,MLM-GUITAR_PICKS,100,133,13,405995,98%
182,MLM-GARDEN_HOSES,154,237,13,406008,98%
242,MLM-MOTORCYCLE_TIRES,336,448,13,406021,98%
456,MLM-FRYING_PANS_WOKS_GRIDDLES_AND_GRILL_PANS,177,288,13,406034,98%
468,MLM-LAPTOP_LCD_SCREENS,131,134,13,406047,98%
625,MLM-INFRARED_AND_BLUETOOTH_ADAPTERS,52,156,13,406060,98%
641,MLM-CELLPHONE_USB_AND_AUXILIARY_ADAPTERS,119,277,13,406073,98%
671,MLM-CLOTHES_HANGERS,65,124,13,406086,98%
733,MLM-BODYSUITS_AND_CATSUITS,153,363,13,406099,98%
788,MLM-VEHICLE_MULTIMEDIA_SYSTEMS,15,226,13,406112,98%
859,MLM-WIRELESS_ANTENNAS,171,242,13,406125,98%
942,MLM-GARDENING_AND_AGRICULTURE_SEEDS,344,465,13,406138,98%
952,MLM-COFFEE_MAKERS,247,417,13,406151,98%
1008,MLM-PLAYING_CARDS,90,150,13,406164,98%
1126,MLM-ROOF_RACKS,182,372,13,406177,98%
1165,MLM-WAX_WARMERS,39,88,13,406190,98%
1213,MLM-CLEANING_MOPS,39,76,13,406203,98%
1415,MLM-STRAWS,88,238,13,406216,98%
1545,MLM-HAIR_MOLDING_AND_STYLING,81,164,13,406229,98%
1659,MLM-CAR_HORNS,54,147,13,406242,98%
1700,MLM-GUITAR_INTERFACES,48,130,13,406255,98%
2108,MLB-KITCHEN_APRONS,305,548,13,406268,98%
2133,MLM-LED_THERAPY_FACE_MASKS,24,100,13,406281,98%
2247,MLB-BICYCLE_CHILD_SEATS,225,516,13,406294,98%
2371,MLB-AUTOMOTIVE_BATTERIES,962,1671,13,406307,98%
2499,MLB-CACAO,82,135,13,406320,98%
2717,MLB-HOME_ELECTRIC_KNIFE_SHARPENERS,42,94,13,406333,98%
2814,MLB-AUTOMOTIVE_FOG_LIGHT_GRILLS,637,772,13,406346,98%
2883,MLB-AUTOMOTIVE_SPRING_SUSPENSIONS,556,741,13,406359,98%
3288,MLM-RICE,14,18,13,406372,98%
3611,MLB-ACOUSTIC_PANELS,149,382,13,406385,98%
3680,MLB-RADIO_FREQUENCY_MACHINES,159,366,13,406398,98%
3731,MLB-THERMAL_CUPS_AND_TUMBLERS,450,641,13,406411,98%
3861,MLB-CELLPHONE_REPAIR_TOOL_KITS,132,220,13,406424,98%
3959,MLB-CEREAL_BARS,93,203,13,406437,98%
4147,MLM-EROTIC_BODYSUITS_AND_CATSUITS,8,103,13,406450,98%
4215,MLB-BRIEFCASES,210,302,13,406463,98%
4386,MLB-LOCK_PICKS,85,210,13,406476,98%
4397,MLB-HAIRDRESSING_CAPES,169,385,13,406489,98%
4520,MLB-TRUNK_LOCKS,487,618,13,406502,98%
4667,MLB-BABY_SWIMWEAR,336,764,13,406515,98%
4829,MLB-TILE_CUTTERS,210,567,13,406528,98%
4887,MLB-PET_WHEELCHAIRS,27,55,13,406541,98%
4969,MLB-SOLID_SWEET_PASTES,78,88,13,406554,98%
5203,MLB-SCREWDRIVERS_SETS,56,158,13,406567,98%
5232,MLB-DOG_AND_CAT_SHAMPOOS_AND_CONDITIONERS,284,411,13,406580,98%
5488,MLB-ISOPROPYL_ALCOHOLS,29,56,13,406593,98%
5551,MLB-GPS_MAPS,63,105,13,406606,98%
5843,MLB-PHOTOGRAPHIC_STUDIO_FLASHES,32,133,13,406619,98%
5862,MLB-KEY_DUPLICATING_MACHINES,70,253,13,406632,98%
5879,MLB-BACK_GLASS_WIPER_ARMS,23,29,13,406645,98%
5953,MLB-CAMERA_CHARGERS,85,122,13,406658,98%
6080,MLB-BABY_NASAL_ASPIRATORS,95,175,13,406671,98%
6109,MLB-GAME_CONSOLE_CAMERAS_AND_SENSOR_BARS,109,218,13,406684,98%
6369,MLB-COIL_BINDING_MACHINES,79,196,13,406697,98%
6379,MLB-TOILET_PAPERS,58,82,13,406710,98%
112,MLM-BICYCLE_AND_MOTORCYCLE_ALARMS,94,222,12,406722,98%
267,MLM-MANGA,126,208,12,406734,98%
355,MLM-KITCHEN_MOLDS,275,358,12,406746,98%
539,MLM-INSTRUMENT_AMPLIFIERS,237,348,12,406758,98%
653,MLM-DRONES,243,708,12,406770,98%
821,MLM-AUTOMOTIVE_ARMRESTS,53,105,12,406782,98%
915,MLM-ANTI_DECUBITUS_MATTRESSES,30,53,12,406794,98%
1631,MLM-VEHICLE_TRACKERS,54,198,12,406806,98%
1655,MLM-VEHICLE_BICYCLE_CARRIERS,35,59,12,406818,98%
1668,MLM-BARBELL_WEIGHT_SETS,28,142,12,406830,98%
2358,MLB-CLEANING_SUPPLIES,801,1083,12,406842,98%
2500,MLB-LAUNDRY_ROOM_CABINETS,355,1284,12,406854,98%
2792,MLB-BASKETBALL_JERSEYS,192,364,12,406866,98%
3124,MLB-HEADSET_TELEPHONES,59,83,12,406878,98%
3393,MLB-AUTOMOTIVE_LIGHT_SWITCHES,489,570,12,406890,98%
3477,MLB-TABLEWARE_SETS,585,1314,12,406902,98%
3527,MLB-TACTICAL_SLINGS,58,112,12,406914,98%
3579,MLB-BRUSH_CUTTERS,141,274,12,406926,98%
3999,MLB-TATTOO_AFTERCARE_CREAMS,79,100,12,406938,98%
4035,MLB-NOTEBOOKS_AND_WRITING_PADS,742,1051,12,406950,98%
4175,MLB-MOTORCYCLE_JACKETS,817,1758,12,406962,98%
4214,MLB-SPARK_PLUGS,1005,1108,12,406974,99%
4234,MLB-POOL_PUMPS,186,283,12,406986,99%
4321,MLM-BABY_URINALS,2,24,12,406998,99%
4353,MLB-KIDS_MICROPHONES,137,357,12,407010,99%
4496,MLB-PAPER_NAPKINS,105,195,12,407022,99%
4527,MLB-STEERING_WHEEL_COVERS,325,483,12,407034,99%
4531,MLB-BABY_CRIB_BUMPERS,121,282,12,407046,99%
4684,MLM-STREAMING_MEDIA_PLAYER_REMOTE_CONTROLS,12,35,12,407058,99%
4850,MLB-POOL_LIGHTS,160,290,12,407070,99%
5393,MLB-BROCHURE_HOLDERS,51,79,12,407082,99%
5549,MLB-TOOL_BATTERIES,133,303,12,407094,99%
5685,MLB-ICE_CREAM_AND_FROZEN_DESSERTS,45,61,12,407106,99%
5813,MLB-SELF_TANNERS,85,222,12,407118,99%
5921,MLB-AUTOMOTIVE_CENTRAL_DOOR_LOCK_SWITCHES,26,46,12,407130,99%
5978,MLB-NETWORK_TOOL_KITS,41,83,12,407142,99%
6119,MLB-PHOTOGRAPHIC_REFLECTORS,34,45,12,407154,99%
6208,MLB-CARS_AND_VANS_JACK_STANDS,59,154,12,407166,99%
6357,MLB-GOAL_NETS,53,74,12,407178,99%
6716,MLB-NAIL_GLUES,73,192,12,407190,99%
6870,MLB-STRING_TRIMMERS,29,83,12,407202,99%
65,MLM-HOME_APPLIANCES,250,359,11,407213,99%
122,MLM-KEYCHAINS,665,888,11,407224,99%
196,MLM-FLOUR,65,86,11,407235,99%
208,MLM-CAMPING_AND_FISHING_EQUIPMENT,612,802,11,407246,99%
287,MLM-GARDEN_AND_OUTDOOR_SUPPLIES,492,691,11,407257,99%
370,MLM-AUTOMOTIVE_EMBLEMS,289,362,11,407268,99%
410,MLM-BATTERY_CHARGERS,125,249,11,407279,99%
589,MLM-NECKTIES,106,213,11,407290,99%
595,MLM-BABY_TEETHERS,29,95,11,407301,99%
684,MLM-LAPTOP_BATTERIES,186,271,11,407312,99%
784,MLM-SLEEPING_MASKS,78,118,11,407323,99%
827,MLM-PONCHOS,116,219,11,407334,99%
864,MLM-CELL_BATTERIES,130,304,11,407345,99%
1097,MLM-WALL_CLOCKS,203,309,11,407356,99%
1266,MLM-UNIVERSAL_REMOTE_CONTROLS,86,241,11,407367,99%
1268,MLM-MEN_SWIMWEAR,141,250,11,407378,99%
1981,MLM-AUTOMOTIVE_PERFORMANCE_CHIPS,19,47,11,407389,99%
2217,MLB-WINDSHIELD_WIPERS,938,1148,11,407400,99%
2246,MLB-SCULPTURES,1413,1727,11,407411,99%
2448,MLB-FUEL_INJECTORS,844,955,11,407422,99%
2612,MLM-STRAP_ONS,37,106,11,407433,99%
2692,MLB-COURSES,62,95,11,407444,99%
3300,MLB-PACKAGING_ROLLS,130,177,11,407455,99%
3348,MLB-MOLEX_CABLES,40,73,11,407466,99%
3392,MLB-DOOR_AND_WINDOW_LOCKS,549,930,11,407477,99%
3605,MLB-BICYCLE_V_BRAKE_SETS,258,513,11,407488,99%
3823,MLB-TATTOO_MACHINE_POWER_SUPPLIES,59,107,11,407499,99%
3825,MLB-ELECTRODE_PADS,44,55,11,407510,99%
3892,MLB-CAT_TOYS,308,596,11,407521,99%
3944,MLB-JEWELRY_BOXES,269,543,11,407532,99%
4005,MLB-FINGERPRINT_READERS,41,40,11,407543,99%
4312,MLM-INFRARED_THERMOMETERS,16,29,11,407554,99%
5063,MLB-CHURRO_MAKING_MACHINES,80,240,11,407565,99%
5103,MLB-DENTAL_INSTRUMENT_KITS,54,64,11,407576,99%
5220,MLB-WASHING_MACHINE_LINT_FILTERS,45,57,11,407587,99%
5823,MLB-SAUSAGE_CASINGS,72,130,11,407598,99%
6249,MLB-POWER_SUPPLY_TESTERS,33,59,11,407609,99%
6376,MLB-ICED_TEA,11,27,11,407620,99%
6441,MLB-HAND_HELD_REFRACTOMETERS,43,101,11,407631,99%
22,MLM-AUTOMOTIVE_SPEAKERS,742,1324,10,407641,99%
133,MLM-DECORATIVE_VINYLS,775,1198,10,407651,99%
148,MLM-SLIPPERS,245,416,10,407661,99%
190,MLM-BABY_CLOTHING_SETS,191,346,10,407671,99%
275,MLM-SUITS,269,481,10,407681,99%
369,MLM-DOG_POTTY_PADS,45,146,10,407691,99%
377,MLM-COMFORTERS,425,702,10,407701,99%
436,MLM-MUSICAL_KEYBOARDS,262,374,10,407711,99%
461,MLM-CAT_LITTER_BOXES,61,129,10,407721,99%
472,MLM-VR_HEADSETS,86,185,10,407731,99%
483,MLM-WOMEN_SWIMWEAR,500,825,10,407741,99%
856,MLM-AIR_MATTRESSES,120,225,10,407751,99%
871,MLM-BABY_HARNESSES,68,93,10,407761,99%
1129,MLM-WEBCAMS,42,76,10,407771,99%
1230,MLM-VEHICLE_WAXES,108,264,10,407781,99%
1263,MLM-COASTERS,40,99,10,407791,99%
1337,MLM-FRAGRANCE_SETS,112,163,10,407801,99%
1524,MLM-SUNSCREENS,66,146,10,407811,99%
1621,MLM-METAL_DETECTORS,51,135,10,407821,99%
1669,MLM-CELLPHONE_SIGNAL_BOOSTERS,46,79,10,407831,99%
2040,MLB-BAR_SOAPS,339,464,10,407841,99%
2167,MLM-EMERGENCY_LIGHTS,76,172,10,407851,99%
2445,MLB-AUTOMOTIVE_BRIGHTENERS,59,87,10,407861,99%
2548,MLB-STATUES,855,1321,10,407871,99%
2570,MLB-CHOCOLATES,555,754,10,407881,99%
2748,MLB-EYELASH_EXTENSIONS,120,227,10,407891,99%
2897,MLB-WET_BABY_WIPES,381,764,10,407901,99%
2969,MLM-PHOTOGRAPHIC_REFLECTORS,6,14,10,407911,99%
3003,MLB-MOTORCYCLE_INTERCOMMUNICATORS,249,617,10,407921,99%
3067,MLB-AUTOMOTIVE_EXHAUST_CATALYTICS,312,385,10,407931,99%
3096,MLB-MOTORCYCLE_SEAT_COVERS,510,686,10,407941,99%
3305,MLB-DEPILATORY_WAXES,290,526,10,407951,99%
3750,MLB-BIRD_CAGES,793,1811,10,407961,99%
3961,MLB-NETWORK_HUBS,47,57,10,407971,99%
4048,MLB-MAGNETIC_DRAWING_BOARDS,72,190,10,407981,99%
4060,MLM-DOORBELLS,36,81,10,407991,99%
4144,MLB-TABLET_STANDS_AND_MOUNTS,99,184,10,408001,99%
4288,MLB-DANCE_SNEAKERS_AND_SHOES,70,205,10,408011,99%
4378,MLB-LIGHTERS,380,770,10,408021,99%
4466,MLB-DOLL_CRIBS,106,342,10,408031,99%
4590,MLB-GYM_DUMBBELLS,212,535,10,408041,99%
4722,MLB-STOVETOP_POPCORN_POPPERS,115,303,10,408051,99%
4851,MLB-NAIL_ART_BRUSHES,250,463,10,408061,99%
4903,MLB-LABORATORY_MICROTUBES,50,71,10,408071,99%
4970,MLB-GUITAR_PICKUPS,322,454,10,408081,99%
5123,MLB-GAS_CYLINDERS,61,99,10,408091,99%
5329,MLB-NAIL_POLISH_TROLLEYS,113,387,10,408101,99%
5357,MLB-COLLECTIBLE_POSTCARDS,25,35,10,408111,99%
5368,MLB-BASEBOARDS,209,462,10,408121,99%
5840,MLB-BREAST_MILK_STORAGE_BAGS,51,125,10,408131,99%
6001,MLB-HARD_DRIVE_AND_SSD_CADDIES,26,54,10,408141,99%
6073,MLB-ACTION_CAMERA_DOMES,40,76,10,408151,99%
6484,MLB-GYM_LIFTING_STRAPS,66,169,10,408161,99%
170,MLM-FOUNDATIONS,184,314,9,408170,99%
218,MLM-SCREEN_PRINTERS,120,341,9,408179,99%
251,MLM-DESKTOP_COMPUTER_COOLERS_AND_FANS,150,296,9,408188,99%
254,MLM-ANTIQUES,1085,1302,9,408197,99%
402,MLM-REMOTE_CONTROL_TOY_VEHICLES,62,165,9,408206,99%
415,MLM-SURGICAL_MASKS,69,114,9,408215,99%
730,MLM-ROUTERS,131,224,9,408224,99%
798,MLM-MARTIAL_ARTS_AND_BOXING_GLOVES,98,178,9,408233,99%
803,MLM-PROTOBOARDS,43,130,9,408242,99%
850,MLM-ELECTRIC_BRUSH_CUTTERS_AND_STRING_TRIMMERS,54,157,9,408251,99%
870,MLM-KIDS_TRICYCLES,112,184,9,408260,99%
875,MLM-ELECTRIC_CREPE_MAKERS,54,118,9,408269,99%
972,MLM-FISHING_LINES,35,68,9,408278,99%
1156,MLM-LASER_LEVELS,43,98,9,408287,99%
1207,MLM-ELLIPTICAL_MACHINES,44,89,9,408296,99%
1299,MLM-TEA_KETTLES,60,117,9,408305,99%
1494,MLM-LUGGAGE_ORGANIZERS,96,248,9,408314,99%
1672,MLM-SOLDERING_IRONS,100,179,9,408323,99%
1680,MLM-PENIS_SLEEVES,60,177,9,408332,99%
1847,MLB-DOORS,1080,2592,9,408341,99%
2022,MLB-ALTERNATORS,463,552,9,408350,99%
2264,MLM-TRAVEL_AND_TRAINING_BAGS,52,127,9,408359,99%
2450,MLB-HORN_DRIVERS,313,564,9,408368,99%
2466,MLM-MEDICAL_WALKERS,26,54,9,408377,99%
2509,MLB-REFRIGERATOR_AND_FREEZER_DOOR_GASKETS,267,321,9,408386,99%
2542,MLB-PROTECTION_NETS,226,397,9,408395,99%
2649,MLB-BICYCLE_BAGS,262,429,9,408404,99%
2785,MLB-AUTOMOTIVE_BLOW_OFF_VALVES,71,130,9,408413,99%
2973,MLB-TATTOO_NEEDLES,78,114,9,408422,99%
3304,MLB-KATANA_SWORDS,262,725,9,408431,99%
3338,MLB-ESOTERIC_PRODUCTS,132,140,9,408440,99%
3347,MLB-SANDPAPERS,266,363,9,408449,99%
3826,MLB-MAKEUP_PRIMERS,234,394,9,408458,99%
3921,MLB-FLOUR,179,245,9,408467,99%
4044,MLB-AUTOMOTIVE_BED_COVERS,605,837,9,408476,99%
4308,MLB-FOAM_ROLLERS,42,83,9,408485,99%
4380,MLB-STUDIO_MONITORS,216,342,9,408494,99%
4461,MLB-MAKEUP_REMOVERS,161,355,9,408503,99%
4655,MLM-PUNCH_PLIERS,15,23,9,408512,99%
4715,MLB-VIOLIN_AND_VIOLA_STRINGS,59,93,9,408521,99%
4738,MLB-DRILL_CHUCKS,210,343,9,408530,99%
4823,MLB-FISHING_HOOKS,246,358,9,408539,99%
4846,MLB-AUTOMOTIVE_SEAT_RECLINER_HANDLES_AND_LEVERS,377,565,9,408548,99%
4853,MLB-CANDELABRAS,143,262,9,408557,99%
4913,MLB-CLEANING_GLOVES,35,71,9,408566,99%
4949,MLB-WASHING_MACHINE_MOTORS,137,186,9,408575,99%
5018,MLB-HOLE_PUNCHES,270,401,9,408584,99%
5129,MLB-CAMERA_BACKPACKS,150,202,9,408593,99%
5202,MLB-VOLLEYBALL_NETS,81,206,9,408602,99%
5272,MLB-OUTLET_PLUG_COVERS,28,55,9,408611,99%
5848,MLB-FABRIC_NAPKINS,90,156,9,408620,99%
5890,MLB-TOY_CELLPHONES,105,171,9,408629,99%
5925,MLB-TACTICAL_HANDCUFFS,61,112,9,408638,99%
6264,MLB-AQUARIUM_AUTOMATIC_FEEDERS,56,82,9,408647,99%
6361,MLB-VEHICLE_POLISHING_PADS,80,157,9,408656,99%
6473,MLB-COMPUTER_VACUUM_CLEANERS,35,87,9,408665,99%
6575,MLB-BREAST_FEEDING_PILLOWS,117,177,9,408674,99%
6824,MLB-PROJECTOR_MOUNTS,99,148,9,408683,99%
6904,MLB-BLENDER_DRIVE_COUPLINGS,37,50,9,408692,99%
6907,MLB-INGROWN_NAIL_FIXERS,15,22,9,408701,99%
7012,MLB-KEYBOARD_AND_PIANO_PEDALS,40,84,9,408710,99%
7033,MLB-BREATHALYSERS,27,36,9,408719,99%
7080,MLB-MICROWAVE_KEYPADS,26,38,9,408728,99%
7497,MLB-SECURITY_TOKENS,12,31,9,408737,99%
2,MLM-SKIRTS,323,561,8,408745,99%
241,MLM-ANIMAL_AND_PET_PRODUCTS,761,1038,8,408753,99%
270,MLM-GYM_BARS,56,114,8,408761,99%
345,MLM-DESKTOP_COMPUTERS,690,1563,8,408769,99%
406,MLM-MARTIAL_ARTS_AND_BOXING_EQUIPMENT,223,348,8,408777,99%
515,MLM-IRONS,114,156,8,408785,99%
578,MLM-AUDIO_INTERFACES,77,193,8,408793,99%
617,MLM-MAGNETIC_WELDING_HOLDERS,38,66,8,408801,99%
620,MLM-CAMERA_LENSES,188,185,8,408809,99%
665,MLM-MILITARY_COLLECTIBLE_SUPPLIES,286,378,8,408817,99%
760,MLM-RUBBER_STAMPS,121,191,8,408825,99%
801,MLM-HOME_MANUAL_KNIFE_SHARPENERS,42,91,8,408833,99%
1030,MLM-AIR_CONDITIONER_REMOTE_CONTROLS,31,42,8,408841,99%
1210,MLM-MOTORCYCLE_CASES,115,198,8,408849,99%
1240,MLM-MUSICAL_INSTRUMENT_ACCESSORIES,173,213,8,408857,99%
1264,MLM-BABIES_FOOTWEAR,173,279,8,408865,99%
1274,MLM-CARS_AND_VANS_COVERS,39,57,8,408873,99%
1305,MLM-LAPTOP_STANDS,26,74,8,408881,99%
1360,MLM-TOOTHPASTES,51,74,8,408889,99%
1395,MLM-PAINT_SPRAYERS,130,187,8,408897,99%
1429,MLM-PAINTBALL_MASKS,70,139,8,408905,99%
1482,MLM-VOLTAGE_DETECTORS,34,50,8,408913,99%
1618,MLM-MANUAL_FACIAL_BRUSHES_AND_SPONGES,24,53,8,408921,99%
1629,MLM-PIERCINGS,139,210,8,408929,99%
1729,MLM-STRING_INSTRUMENT_EFFECTS_PEDALS,134,224,8,408937,99%
1768,MLM-DIVING_MASKS,32,94,8,408945,99%
1794,MLB-AUTOMOTIVE_SUN_VISORS,313,375,8,408953,99%
1824,MLM-POLYFUSION_DEVICES,24,53,8,408961,99%
1832,MLM-ACOUSTIC_PANELS,56,159,8,408969,99%
1887,MLM-ARCADE_PARTS_KITS,75,196,8,408977,99%
1978,MLM-BATH_TOWELS,57,111,8,408985,99%
2093,MLB-SNACK_HOLDERS,83,157,8,408993,99%
2336,MLB-SCHOOL_AND_OFFICE_GLUES,182,202,8,409001,99%
2551,MLB-AIRBAGS,235,294,8,409009,99%
2723,MLB-VEHICLE_SPEAKERS,1473,2411,8,409017,99%
2750,MLB-BABY_BOUNCERS,149,213,8,409025,99%
2777,MLB-GLOVES_AND_MITTENS,293,414,8,409033,99%
2942,MLM-TIE_BARS,26,44,8,409041,99%
3016,MLB-DECORATIVE_FLUORESCENT_STICKERS,85,149,8,409049,99%
3052,MLB-ANALOG_CAMERAS,269,439,8,409057,99%
3111,MLB-TEAPOTS,106,197,8,409065,99%
3329,MLB-VEHICLE_CARBURETOR_ACCELERATOR_CABLES,159,181,8,409073,99%
3355,MLB-DOOR_HYDRAULIC_ARMS,77,93,8,409081,99%
3370,MLB-GARDEN_BENCHES,197,405,8,409089,99%
3418,MLB-FABRICS,1127,1767,8,409097,99%
3455,MLB-CELLPHONE_SIGNAL_BOOSTERS,106,177,8,409105,99%
3499,MLM-BUNION_CORRECTORS,30,38,8,409113,99%
3538,MLB-MANUAL_SCREWDRIVERS,191,588,8,409121,99%
3648,MLB-LAPTOP_BRIEFCASES,150,354,8,409129,99%
3935,MLB-MOTORCYCLE_BATTERIES,532,848,8,409137,99%
4031,MLB-BUTTON_PINS,168,165,8,409145,99%
4178,MLB-GARDEN_CHAIRS,306,684,8,409153,99%
4232,MLB-FISH_FINDERS,38,59,8,409161,99%
4376,MLB-BICYCLE_DISC_BRAKE_SETS,88,212,8,409169,99%
4674,MLB-CERVICAL_COLLARS,41,63,8,409177,99%
4732,MLB-MOTORCYCLE_SUITS,175,285,8,409185,99%
4797,MLB-WHEEL_LUG_WRENCHES,104,171,8,409193,99%
4880,MLB-BICYCLE_AND_MOTORCYCLE_LOCKS,74,131,8,409201,99%
5047,MLB-MARTIAL_ARTS_BELTS,111,223,8,409209,99%
5107,MLB-PARKING_BRAKE_HANDLES,201,234,8,409217,99%
5151,MLB-REED_DIFFUSERS,59,144,8,409225,99%
5235,MLB-ELECTRIC_LAWN_MOWERS,39,85,8,409233,99%
5298,MLB-NATIVITY_SCENES,169,306,8,409241,99%
5395,MLB-SKATEBOARD_BEARINGS,113,201,8,409249,99%
5422,MLB-COMPOSTERS,57,144,8,409257,99%
5470,MLB-AUTOMOTIVE_ENGINE_OIL_PANS,136,173,8,409265,99%
5558,MLB-AUTOMOTIVE_BOARD_ROOF_RACKS,55,127,8,409273,99%
5688,MLB-CANDY_AND_BALL_VENDING_MACHINES,97,212,8,409281,99%
5804,MLB-MULTIPURPOSE_TARPS,254,403,8,409289,99%
5861,MLB-CELLPHONE_CHARGER_PIN_BOARDS,68,156,8,409297,99%
6220,MLB-PORTABLE_GAME_CONSOLE_POWER_SUPPLIES,35,58,8,409305,99%
6323,MLB-COLOSTOMY_BAGS,38,32,8,409313,99%
6367,MLB-CAMERA_STRAPS,43,96,8,409321,99%
6548,MLM-ENGINE_COMPRESSION_TESTERS,4,16,8,409329,99%
6561,MLB-PORTABLE_GAME_CONSOLE_BATTERIES,33,62,8,409337,99%
6607,MLB-COUNTERFEIT_MONEY_DETECTOR_MACHINE,34,118,8,409345,99%
6651,MLB-PET_DOORS,29,117,8,409353,99%
6735,MLB-EDUCATIONAL_SOFTWARE,53,53,8,409361,99%
6741,MLB-BIRD_SPIKES,14,25,8,409369,99%
6890,MLB-GYMNASTIC_RINGS,16,47,8,409377,99%
6921,MLB-STREAMING_MEDIA_PLAYER_REMOTE_CONTROLS,20,23,8,409385,99%
7521,MLB-IDENTIFICATION_AND_PRESENTATION_CARD_CUTTERS,5,61,8,409393,99%
42,MLM-BINOCULARS,85,133,7,409400,99%
43,MLM-BICYCLES,882,1514,7,409407,99%
50,MLM-WALL_LIGHT_SWITCHES,111,226,7,409414,99%
73,MLM-SPORT_AND_MEDICAL_BANDAGES,90,212,7,409421,99%
156,MLM-CONDOMS,169,329,7,409428,99%
201,MLM-TABLET_SCREENS,192,177,7,409435,99%
234,MLM-COMPUTER_MOTHERBOARDS,397,766,7,409442,99%
331,MLM-REFRIGERATORS,381,616,7,409449,99%
367,MLM-WARDROBES,199,449,7,409456,99%
372,MLM-BABY_WALKERS,106,186,7,409463,99%
376,MLM-SPEED_LADDERS,20,41,7,409470,99%
385,MLM-CANDIES,258,364,7,409477,99%
392,MLM-SCARVES,106,149,7,409484,99%
458,MLM-COMBUSTION_BRUSH_CUTTERS_AND_STRING_TRIMMERS,33,132,7,409491,99%
470,MLM-TACTICAL_GLOVES,44,237,7,409498,99%
488,MLM-INSECTICIDES,105,152,7,409505,99%
642,MLM-DIGITAL_VOICE_RECORDERS,40,59,7,409512,99%
697,MLM-PADS,50,94,7,409519,99%
761,MLM-AUTOMOTIVE_SHIFT_LEVER_KNOBS,142,227,7,409526,99%
787,MLM-BABY_STROLLERS,300,400,7,409533,99%
797,MLM-KNEE_BRACES_SUPPORTS,117,238,7,409540,99%
892,MLM-SCHOOL_AND_OFFICE_GLUES,68,65,7,409547,99%
914,MLM-MULTI_TOOL_KNIVES,273,496,7,409554,99%
947,MLM-VEHICLE_SPEAKERS,218,390,7,409561,99%
1036,MLM-CAKE_STANDS,55,117,7,409568,99%
1079,MLM-WIRELESS_CHARGERS,129,201,7,409575,99%
1087,MLM-SMARTWATCH_CHARGERS,36,62,7,409582,99%
1093,MLM-SAFETY_GOGGLES,64,99,7,409589,99%
1296,MLM-AB_ROLLER_WHEELS,33,74,7,409596,99%
1318,MLM-GARDEN_SPRAYERS,84,159,7,409603,99%
1475,MLM-MAGNETIC_FUEL_SAVERS,40,90,7,409610,99%
1611,MLM-PHOTO_STUDIO_KITS,20,46,7,409617,99%
1775,MLB-EPILATORS,158,334,7,409624,99%
1820,MLM-COIN_PURSES,99,196,7,409631,99%
1917,MLM-TURBANS,13,35,7,409638,99%
1988,MLM-PORTABLE_HANGING_SCALES,26,38,7,409645,99%
2014,MLB-GARDENING,404,577,7,409652,99%
2068,MLM-COCKTAIL_SHAKERS,21,42,7,409659,99%
2319,MLB-BABY_COLOGNES,124,376,7,409666,99%
2375,MLB-PRICE_TAG_HOLDERS,163,202,7,409673,99%
2413,MLM-THERMAL_PADS,9,22,7,409680,99%
2567,MLB-MOTORCYCLE_MUFFLERS,621,862,7,409687,99%
2647,MLM-CUTTING_PLOTTERS,36,155,7,409694,99%
2685,MLB-AUTOMOTIVE_TURBOCHARGERS,621,828,7,409701,99%
2759,MLM-BDSM_KITS,29,88,7,409708,99%
2819,MLM-HARD_DRIVE_AND_SSD_CADDIES,26,73,7,409715,99%
2930,MLB-SCREW_EXTRACTORS,63,120,7,409722,99%
3107,MLB-AUTOMOTIVE_AC_COMPRESSORS,569,654,7,409729,99%
3150,MLB-CELLPHONE_AND_TABLET_SKINS,166,209,7,409736,99%
3293,MLM-BABY_SAFETY_HELMETS,44,95,7,409743,99%
3386,MLB-TACTICAL_BELTS,128,203,7,409750,99%
3478,MLB-JEWELRY_TOOLS,197,256,7,409757,99%
3577,MLB-FOOTBALL_CAPS,273,382,7,409764,99%
3705,MLB-SLINGSHOTS,108,227,7,409771,99%
3728,MLB-HABERDASHERY_RIBBONS,324,635,7,409778,99%
3782,MLB-PUZZLES,562,712,7,409785,99%
4550,MLB-NAIL_POLISH_REMOVERS,56,103,7,409792,99%
4585,MLB-GREASE_GUNS,91,155,7,409799,99%
4791,MLB-NETWORK_PLUGS,42,48,7,409806,99%
4936,MLB-TOASTERS,70,177,7,409813,99%
4954,MLB-COLANDERS,48,88,7,409820,99%
5078,MLB-RUBBER_FLOORS,138,334,7,409827,99%
5104,MLB-OTOSCOPES,69,62,7,409834,99%
5156,MLB-SAXOPHONE_AND_CLARINET_REEDS,166,211,7,409841,99%
5237,MLB-TOY_MICROWAVES,45,108,7,409848,99%
5356,MLB-RAZOR_BLADES,50,85,7,409855,99%
5411,MLB-HAND_GRIPS,80,121,7,409862,99%
5539,MLB-KEYBOARD_AND_DIGITAL_PIANO_STANDS,80,144,7,409869,99%
5711,MLB-HAIR_DRYER_DIFFUSERS,40,112,7,409876,99%
5750,MLB-BEANS,20,33,7,409883,99%
5756,MLB-TABLE_BASES,72,112,7,409890,99%
5838,MLB-TABLE_SAWS,147,506,7,409897,99%
6058,MLB-ERASERS,60,76,7,409904,99%
6343,MLB-FISH_TANK_HOODS,81,103,7,409911,99%
6351,MLB-GAME_CONSOLE_LASER_LENSES,86,111,7,409918,99%
6486,MLB-FOOTBALL_SHOE_BAGS,78,152,7,409925,99%
6539,MLB-COCKTAIL_SETS,38,119,7,409932,99%
6630,MLB-MEDICAL_WALKERS,24,43,7,409939,99%
6744,MLB-FOOD_AND_DRINK_EXTRACTS,35,70,7,409946,99%
6969,MLB-MEGAPHONES,31,52,7,409953,99%
7176,MLB-ANTI_STATIC_BAGS,4,3,7,409960,99%
7253,MLB-RODENT_TRAPS,27,51,7,409967,99%
7338,MLB-AUTOMOTIVE_STEERING_WHEEL_SPINNERS,18,22,7,409974,99%
7439,MLB-HARD_DRIVE_AND_SSD_DOCKING_STATIONS,17,26,7,409981,99%
220,MLM-JEWELRY_AND_WATCHES,307,443,6,409987,99%
284,MLM-COAT_RACKS,73,125,6,409993,99%
352,MLM-MUSICAL_KEYBOARD_CASES_AND_BAGS,30,44,6,409999,99%
383,MLM-MUSIC_ALBUMS,567,676,6,410005,99%
390,MLM-ANALOG_CAMERAS,95,165,6,410011,99%
510,MLM-PHOTO_ALBUMS,82,170,6,410017,99%
527,MLM-MULTIGAME_MACHINES,165,321,6,410023,99%
550,MLM-SOUND_CONSOLES_AND_MIXERS,126,235,6,410029,99%
574,MLM-TOOL_BOXES,292,581,6,410035,99%
623,MLM-CELLPHONE_SELFIE_LIGHTS,22,31,6,410041,99%
678,MLM-ORTHOPEDIC_CANES,34,51,6,410047,99%
725,MLM-HAIR_DRYERS,111,174,6,410053,99%
739,MLM-PENNANTS,96,94,6,410059,99%
763,MLM-BATHROOM_FAUCETS,145,189,6,410065,99%
807,MLM-RADIO_FREQUENCY_MICROPHONES,127,294,6,410071,99%
878,MLM-PENCILS,160,270,6,410077,99%
979,MLM-NEBULIZERS,21,51,6,410083,99%
994,MLM-MICROPHONE_STANDS,17,29,6,410089,99%
1114,MLM-PERMANENT_EPILATORS,37,106,6,410095,99%
1215,MLM-ARCADE_MACHINE_COIN_DOORS,22,39,6,410101,99%
1247,MLM-CELLPHONE_AND_TABLET_REPLACEMENT_BUTTONS,44,78,6,410107,99%
1273,MLM-ROBES,72,96,6,410113,99%
1326,MLM-HYDRAULIC_VEHICLE_JACKS,73,104,6,410119,99%
1353,MLM-BABY_FEEDING_PACIFIERS,16,44,6,410125,99%
1380,MLM-BOTTLE_OPENERS,66,150,6,410131,99%
1427,MLM-VOLLEYBALL_BALLS,47,109,6,410137,99%
1435,MLM-DOG_NAIL_CLIPPERS,17,62,6,410143,99%
1515,MLM-TOILET_PAPERS,33,89,6,410149,99%
1519,MLM-SHOWER_AND_TOILET_CHAIRS,30,35,6,410155,99%
1535,MLM-SHAKER_BOTTLES,74,122,6,410161,99%
1566,MLB-PRECIOUS_AND_SEMI_PRECIOUS_STONES,509,741,6,410167,99%
1797,MLB-DJ_CONTROLLERS,324,502,6,410173,99%
1874,MLM-DOOR_AND_WINDOW_WEATHERSTRIPS,16,61,6,410179,99%
1935,MLM-COLOSTOMY_BAGS,32,38,6,410185,99%
1942,MLM-CALIPERS,44,39,6,410191,99%
2020,MLB-PORTABLE_GENERATORS,410,920,6,410197,99%
2198,MLM-KARAOKE_MICROPHONES,18,87,6,410203,99%
2305,MLM-PILL_BOXES,50,57,6,410209,99%
2390,MLB-MOTORCYCLE_FENDERS,911,1245,6,410215,99%
2491,MLB-GROUND_AND_WHOLE_BEANS_COFFEE,146,194,6,410221,99%
2880,MLB-MACHETES,172,312,6,410227,99%
2931,MLB-MOTORCYCLE_CDI_MODULES,206,243,6,410233,99%
3135,MLB-AUTOMOTIVE_ENGINE_COOLANT_THERMOSTATS,567,643,6,410239,99%
3362,MLM-VIDEO_CAPTURE_DEVICES,35,68,6,410245,99%
3453,MLM-BABY_KNEE_PADS,17,53,6,410251,99%
3623,MLB-RADIO_BASE_STATIONS,251,330,6,410257,99%
3660,MLM-ORTHOPEDIC_SHOULDER_PADS,14,28,6,410263,99%
3667,MLB-SIDE_TABLES,287,630,6,410269,99%
3760,MLB-ADULT_DIAPERS,152,356,6,410275,99%
3787,MLB-ANTI_STATIC_MAGNETIC_MATS,33,67,6,410281,99%
3832,MLB-MEMORY_CARD_CASES_AND_BAGS,26,26,6,410287,99%
3862,MLB-BALANCE_DISCS_AND_HALF_BALLS,48,96,6,410293,99%
3895,MLM-TAG_PIN_GUNS,12,29,6,410299,99%
4089,MLB-CHOCOLATE_TEMPERING_MACHINES,19,62,6,410305,99%
4225,MLB-AIR_CONDITIONER_CONTROL_BOARDS,52,91,6,410311,99%
4274,MLB-AUTOMOTIVE_REAR_BUMPERS,653,796,6,410317,99%
4292,MLB-BICYCLE_CARGO_RACKS,66,121,6,410323,99%
4424,MLB-MERCHANDISER_REFRIGERATORS,559,976,6,410329,99%
4492,MLB-TABLETOP_FOUNTAINS,339,758,6,410335,99%
4672,MLB-COMBINED_TOOL_SETS,157,256,6,410341,99%
4699,MLB-ELECTRIC_GLUE_GUNS,129,248,6,410347,99%
4787,MLB-PNEUMATIC_DOOR_CLOSERS,33,42,6,410353,99%
4855,MLB-BUTTER_PAPERS,22,80,6,410359,99%
4938,MLB-KID_SKATEBOARDS,82,252,6,410365,99%
4944,MLM-UNDERWEAR_ORGANIZERS,11,23,6,410371,99%
4998,MLB-DOG_NAIL_CLIPPERS,50,89,6,410377,99%
5041,MLB-TEMPORARY_TATTOOS,172,651,6,410383,99%
5054,MLB-SOAP_AND_DETERGENT_DISPENSERS,217,416,6,410389,99%
5077,MLB-ELECTRIC_CREPE_MAKERS,53,100,6,410395,99%
5256,MLB-VEHICLE_BICYCLE_CARRIERS,244,526,6,410401,99%
5299,MLB-AUTOMOTIVE_TAIL_LIGHT_LENSES,212,276,6,410407,99%
5307,MLB-SALT_AND_PEPPER_SHAKERS,186,291,6,410413,99%
5364,MLB-TOY_GUITARS,160,243,6,410419,99%
5560,MLB-CLASSROOM_DESKS,74,161,6,410425,99%
5622,MLB-IRRIGATION_KITS,40,74,6,410431,99%
5723,MLB-NAIL_STAMPS,147,370,6,410437,99%
5811,MLB-VEILS,182,302,6,410443,99%
5880,MLB-TOILET_FLUSH_VALVES,46,62,6,410449,99%
5946,MLB-POOL_INFLATABLES,122,197,6,410455,99%
5974,MLB-GARAGE_WALL_PROTECTORS,29,48,6,410461,99%
6077,MLB-VIOLIN_AND_VIOLA_SHOULDER_RESTS,45,66,6,410467,99%
6127,MLB-SQUEEGEES,38,48,6,410473,99%
6154,MLB-TICKET_NUMBER_DISPENSER_ROLLS,9,13,6,410479,99%
6179,MLB-DROPPING_BOTTLES,30,34,6,410485,99%
6194,MLB-GYMNASTIC_KNEE_PADS,58,192,6,410491,99%
6212,MLB-KITCHEN_TONGS,36,48,6,410497,99%
6327,MLB-INK_CARTRIDGE_REFILL_MACHINES,12,51,6,410503,99%
6591,MLB-ARTIFICIAL_FEATHERS,19,26,6,410509,99%
6732,MLB-SCARVES,59,106,6,410515,99%
7099,MLB-TELEPROMPTERS,17,42,6,410521,99%
7636,MLB-STUN_GUNS,14,41,6,410527,99%
10,MLM-ESTHETIC_ELECTRIC_DEVICES,27,42,5,410532,99%
23,MLM-ELECTRIC_DEHUMIDIFIERS,32,40,5,410537,99%
104,MLM-LED_STAGE_LIGHTS,170,272,5,410542,99%
186,MLM-WORK_SCRUBS,183,222,5,410547,99%
338,MLM-LINGERIE_SETS,186,393,5,410552,99%
363,MLM-STICKY_NOTES,65,124,5,410557,99%
465,MLM-CAR_SEAT_COVERS,567,700,5,410562,99%
536,MLM-GAUZES,33,44,5,410567,99%
599,MLM-SLEEPING_BAGS,74,87,5,410572,99%
650,MLM-WORKOUT_BENCHES,102,194,5,410577,99%
682,MLM-ADHESIVE_TAPES,130,160,5,410582,99%
700,MLM-MUSICAL_INSTRUMENTS,319,418,5,410587,99%
736,MLM-TOWEL_HOLDERS,34,75,5,410592,99%
808,MLM-CURLING_IRONS,71,141,5,410597,99%
818,MLM-LAUNDRY_DETERGENTS,45,57,5,410602,99%
819,MLM-PARTY_FAVOR_BRACELETS_AND_NECKLACES,45,80,5,410607,99%
992,MLM-WRESTLING_MASKS,87,121,5,410612,99%
1011,MLM-SWIMMING_GOGGLES,56,135,5,410617,99%
1041,MLM-FOG_MACHINES,39,64,5,410622,99%
1092,MLM-PENCIL_CASES,86,193,5,410627,99%
1096,MLM-BLOOD_GLUCOSE_METERS,54,107,5,410632,99%
1225,MLM-WHISKEYS,106,233,5,410637,99%
1238,MLM-COMPLETE_SKATEBOARDS,59,108,5,410642,99%
1276,MLM-ELECTRIC_CIRCULAR_SAWS,119,172,5,410647,99%
1349,MLM-HOME_SHELVES,137,239,5,410652,99%
1384,MLM-STEERING_WHEEL_COVERS,100,177,5,410657,99%
1386,MLM-PH_METERS,18,35,5,410662,99%
1409,MLM-ELECTRIC_LAWN_MOWERS,8,21,5,410667,99%
1432,MLM-PAINTBALLS,9,15,5,410672,99%
1470,MLM-CELLPHONE_CAMERA_PROTECTORS,66,161,5,410677,99%
1504,MLM-FACIAL_STEAMERS,33,64,5,410682,99%
1598,MLB-TURBANS,98,218,5,410687,99%
1614,MLM-ELECTRIC_LINT_REMOVERS,16,11,5,410692,99%
1664,MLM-GEL_NAIL_KITS,47,238,5,410697,99%
1726,MLM-CELLPHONE_CHARGER_PIN_BOARDS,37,59,5,410702,99%
1812,MLM-EMERGENCY_THERMAL_BLANKETS,14,32,5,410707,99%
1853,MLM-UNIVERSAL_HOME_GYMS,58,105,5,410712,99%
1879,MLM-HONEY,28,37,5,410717,99%
1953,MLB-IGNITION_SWITCH_ACTUATORS,144,182,5,410722,99%
2282,MLM-BICYCLE_DISC_BRAKE_SETS,21,55,5,410727,99%
2401,MLB-GAME_CONSOLE_AND_VIDEO_GAME_CONTROLLER_SKINS,169,298,5,410732,99%
2502,MLB-DEEP_FRY_BASKETS,73,125,5,410737,99%
2532,MLM-DECORATIVE_LIGHT_SIGNS,8,17,5,410742,99%
2670,MLB-CELLPHONE_AND_TABLET_MOTHERBOARDS,622,681,5,410747,99%
2675,MLB-MOVIES,1068,1196,5,410752,99%
2706,MLM-BICYCLE_TOOL_KITS,21,92,5,410757,99%
2715,MLB-EXHAUST_MANIFOLDS,197,242,5,410762,99%
2839,MLB-MOTORCYCLE_LICENSE_PLATE_BRACKETS,425,620,5,410767,99%
2894,MLB-DOG_CARRIERS_AND_CARRYING_BAGS,360,622,5,410772,99%
2901,MLB-BOTTLE_OPENERS,118,161,5,410777,99%
2903,MLB-SUSPENSION_CONTROL_ARM_BUSHINGS,1221,1484,5,410782,99%
3039,MLM-AUTOMOTIVE_PET_SEAT_COVERS,15,50,5,410787,99%
3080,MLB-AUTOMOTIVE_CHROME_TRIMS,720,951,5,410792,99%
3193,MLB-DISHES_PLATES,563,1170,5,410797,99%
3210,MLB-TONER_CHIPS,45,69,5,410802,99%
3211,MLB-KITCHEN_GRATERS,103,154,5,410807,99%
3268,MLB-AUTOMOTIVE_EXHAUST_TIPS,173,252,5,410812,99%
3297,MLB-BICYCLE_TIRE_REPAIR_KITS,230,369,5,410817,99%
3461,MLB-BABY_SAFETY_HELMETS,21,83,5,410822,99%
3498,MLB-AUTOMOTIVE_HAZARD_WARNING_SWITCHES,64,74,5,410827,99%
3539,MLB-COFFEE_TABLES,339,713,5,410832,99%
3583,MLB-PARTY_HATS,280,349,5,410837,99%
3651,MLB-ENGINE_OIL_DIPSTICKS,172,203,5,410842,99%
3724,MLB-TRANSISTORS,281,320,5,410847,99%
3827,MLB-HYDRAULIC_RAM_PUMPS,55,112,5,410852,99%
3899,MLM-TONIC_WATERS,12,10,5,410857,99%
3932,MLB-SHOELACES,42,62,5,410862,99%
4159,MLB-SECURITY_SEALS,151,183,5,410867,99%
4191,MLB-ELECTRIC_DRILL_AND_SCREWDRIVER_BITS,163,363,5,410872,99%
4201,MLB-CAMPING_CHAIRS,141,206,5,410877,99%
4344,MLB-ACTION_CAMERA_MOUNTS,24,45,5,410882,99%
4349,MLB-NEOPRENE_BOOTS,82,186,5,410887,99%
4428,MLB-BABY_PHOTOGRAPHIC_POSITIONERS,31,50,5,410892,99%
4452,MLM-DRINK_DISPENSERS,24,35,5,410897,99%
4504,MLB-CONTINUOUS_INK_SYSTEMS,112,233,5,410902,99%
4519,MLB-AUTOMOTIVE_BRAKE_CALIPER_COVERS,237,342,5,410907,99%
4599,MLB-AQUARIUM_LIGHTS,262,313,5,410912,99%
4614,MLB-VIDEO_PLAYER_AND_GAME_CONSOLE_STANDS,216,300,5,410917,99%
4665,MLB-EROTIC_CREAMS,178,274,5,410922,99%
4726,MLB-WASHING_MACHINE_DOOR_AND_LID_GASKETS,29,21,5,410927,99%
4771,MLB-GLASSES_CASES_AND_BAGS,50,90,5,410932,99%
4910,MLB-MOTORCYCLE_WINDSHIELDS,248,325,5,410937,99%
5071,MLB-BABY_PACIFIER_CLIPS,115,218,5,410942,99%
5098,MLB-CYCLING_SHOES,276,456,5,410947,99%
5169,MLB-VEHICLE_SHAMPOOS,165,270,5,410952,99%
5228,MLB-BEACH_BALLS,35,91,5,410957,99%
5240,MLB-TEXTILE_LABELS,75,192,5,410962,99%
5258,MLB-LIGHT_STANDS,58,82,5,410967,99%
5343,MLB-SODIUM_BICARBONATE,31,43,5,410972,99%
5382,MLB-TOY_PEDAL_CARS,73,220,5,410977,99%
5383,MLB-MARTIAL_ARTS_SHIN_GUARDS,122,293,5,410982,99%
5420,MLB-CONTAINER_CAPS_AND_PLUGS,38,54,5,410987,99%
5428,MLB-BIRD_DRINKERS_AND_FEEDERS,236,420,5,410992,99%
5582,MLB-DOOR_AND_GATE_REMOTE_CONTROLS,112,156,5,410997,99%
5668,MLB-COMPRESSION_SOCKS,26,16,5,411002,99%
5684,MLB-WHIPPED_CREAM_DISPENSERS,26,43,5,411007,99%
5721,MLB-INTERACTIVE_GAMING_FIGURES,71,109,5,411012,99%
5772,MLB-PASTRY_BAGS,62,180,5,411017,99%
5947,MLB-ELECTRIC_LINT_REMOVERS,40,69,5,411022,99%
6017,MLB-RUGBY_JERSEYS,42,95,5,411027,99%
6039,MLB-GARLIC_PRESSES,28,56,5,411032,99%
6162,MLB-MAGNETIC_FUEL_SAVERS,29,96,5,411037,99%
6238,MLB-VOLLEYBALL_KNEE_PADS,43,54,5,411042,99%
6239,MLB-SWIMMING_POOL_HEATERS,72,156,5,411047,99%
6292,MLB-PAELLA_PANS,30,45,5,411052,99%
6313,MLB-CHIP_AND_DIP_SERVERS,91,161,5,411057,99%
6421,MLB-BB_CREAMS,57,126,5,411062,99%
6433,MLB-SLEEPING_MASKS,65,85,5,411067,99%
6517,MLB-BATHROOM_EXHAUST_FANS,94,194,5,411072,99%
6524,MLB-WAITER_CALLING_SYSTEMS,19,40,5,411077,99%
6557,MLB-BILL_COUNTERS,46,68,5,411082,99%
6615,MLB-DC_POWER_JACK_CONNECTORS,102,137,5,411087,99%
6673,MLB-PAINTBALLS,68,120,5,411092,99%
6784,MLB-CAMERA_AND_VIDEO_CAMERA_BAGS_AND_CASES,79,89,5,411097,99%
6935,MLB-STADIOMETERS,35,51,5,411102,100%
6951,MLB-PUNCH_PLIERS,19,35,5,411107,100%
6955,MLB-STUN_GUN_FLASHLIGHTS,16,85,5,411112,100%
6956,MLB-WASHING_AND_DRYER_MACHINE_SEALS,68,92,5,411117,100%
6970,MLB-CAMPING_MESS_KITS,30,39,5,411122,100%
7022,MLB-ITEM_FINDERS,54,172,5,411127,100%
7221,MLB-POP_FILTERS,23,47,5,411132,100%
7262,MLB-TIE_BARS,30,54,5,411137,100%
15,MLM-WASHING_MACHINES,240,415,4,411141,100%
142,MLM-TOOL_AND_CONSTRUCTION_SUPPLIES,259,263,4,411145,100%
320,MLM-PHOTOGRAPHIC_DIFFUSERS,42,48,4,411149,100%
354,MLM-INTERACTIVE_GAMING_FIGURES,55,79,4,411153,100%
398,MLM-BOXING_SPEED_BAGS,26,40,4,411157,100%
413,MLM-EDIBLE_SEEDS,31,49,4,411161,100%
490,MLM-MOTORCYCLE_BATTERIES,97,104,4,411165,100%
491,MLM-DOG_GROOMING_SCISSORS,13,12,4,411169,100%
518,MLM-PASTRY_MAKING_SETS,29,60,4,411173,100%
563,MLM-WOOD_BURNING_MACHINES,22,55,4,411177,100%
632,MLM-SERVING_AND_HOME_TRAYS,94,103,4,411181,100%
690,MLM-TRUNK_LOCKS,50,68,4,411185,100%
791,MLM-NOTEBOOK_CASES,152,263,4,411189,100%
814,MLM-RANGES,191,292,4,411193,100%
894,MLM-DROPPING_BOTTLES,9,10,4,411197,100%
913,MLM-MAGNETIC_COMPASSES,59,95,4,411201,100%
917,MLM-MOTORCYCLE_JACKETS,245,422,4,411205,100%
924,MLM-JIG_SAWS,44,64,4,411209,100%
996,MLM-INDUSTRIAL_SAWS,78,139,4,411213,100%
1023,MLM-CAMERA_AND_CELLPHONE_STABILIZERS,83,224,4,411217,100%
1049,MLM-SELF_DEFENSE_TELESCOPIC_BATONS,64,128,4,411221,100%
1089,MLM-MOTORCYCLE_HEADLIGHTS,69,149,4,411225,100%
1143,MLM-DECORATIVE_FLUORESCENT_STICKERS,46,107,4,411229,100%
1167,MLM-BICYCLE_WALL_MOUNT_RACKS,29,73,4,411233,100%
1191,MLM-MANUAL_PAPER_CUTTERS,24,29,4,411237,100%
1209,MLM-AUTOMOTIVE_THROTTLE_BODIES,87,115,4,411241,100%
1212,MLM-AQUARIUM_FILTERS,91,137,4,411245,100%
1217,MLM-LADDERS,67,122,4,411249,100%
1222,MLM-GUITAR_STRINGS,52,68,4,411253,100%
1311,MLM-ELECTRIC_MASSAGES_MATS,4,11,4,411257,100%
1367,MLM-FIRE_EXTINGUISHERS,24,35,4,411261,100%
1387,MLM-VEHICLE_POLISHING_PADS,35,78,4,411265,100%
1411,MLM-COOKIES_CUTTERS,188,264,4,411269,100%
1489,MLM-TACTICAL_BAGS_AND_BACKPACKS,73,138,4,411273,100%
1570,MLM-PARTY_HATS,86,99,4,411277,100%
1654,MLM-ENGINE_VALVES,15,26,4,411281,100%
1667,MLM-DISPOSABLE_AND_REFILLABLE_RAZORS,30,34,4,411285,100%
1921,MLM-PACKAGING_BOXES,49,49,4,411289,100%
1930,MLM-SUBMERSIBLE_PARTY_LIGHTS,22,37,4,411293,100%
2047,MLB-MOTORCYCLE_WHEELS,1112,1760,4,411297,100%
2149,MLM-LAPTOP_REPLACEMENT_ANTENNAS,13,18,4,411301,100%
2260,MLM-PLANNERS_AND_PERSONAL_DIARIES,70,75,4,411305,100%
2270,MLB-STRAP_ONS,231,303,4,411309,100%
2276,MLB-FISHING_TACKLE_BOXES,201,315,4,411313,100%
2399,MLB-DIVING_KITS,103,181,4,411317,100%
2591,MLM-ADULT_DIAPERS,22,33,4,411321,100%
2603,MLB-HOME_FURNITURE,794,1230,4,411325,100%
2676,MLB-CASH_DRAWERS,53,244,4,411329,100%
2753,MLB-LAUNDRY_BASKETS,146,317,4,411333,100%
2775,MLB-FOOTBALL_SOCKS,204,427,4,411337,100%
2835,MLB-FOOTBALL_EQUIPMENT_AND_ACCESSORIES,290,446,4,411341,100%
2864,MLM-HEATING_PADS,19,20,4,411345,100%
2999,MLM-CAMPING_CHAIRS,27,71,4,411349,100%
3002,MLB-TOY_SWORDS,127,220,4,411353,100%
3037,MLM-FREEZER_BAGS,8,21,4,411357,100%
3049,MLB-STICKER_ALBUMS,178,159,4,411361,100%
3152,MLB-SYNTHETIC_GRASS,64,204,4,411365,100%
3178,MLB-HAND_AND_FOOT_CREAMS,169,220,4,411369,100%
3208,MLB-MOTORCYCLE_CLUTCH_COVERS,417,516,4,411373,100%
3240,MLM-GARMENT_COVERS,20,24,4,411377,100%
3277,MLB-STORE_SALE_PRICE_TAGS,54,65,4,411381,100%
3402,MLB-GAS_LIFT_SUPPORTS,420,513,4,411385,100%
3413,MLB-PROJECTOR_LAMPS,62,73,4,411389,100%
3457,MLB-FONDUE_SETS,77,116,4,411393,100%
3471,MLB-NAIL_POWDERS,166,339,4,411397,100%
3518,MLB-VIDEO_GAME_CONTROLLER_COVERS,105,135,4,411401,100%
3557,MLB-RADIATOR_CAPS,187,240,4,411405,100%
3662,MLB-PLACEMATS,285,476,4,411409,100%
3685,MLM-TRUMPETS,42,91,4,411413,100%
3736,MLB-WHEELCHAIRS,170,257,4,411417,100%
3746,MLB-CV_JOINTS,423,489,4,411421,100%
3759,MLB-AUTOMOTIVE_BUMPER_BRACKETS,408,443,4,411425,100%
3781,MLB-DIAPER_BAG_SETS,23,36,4,411429,100%
3810,MLB-TOOL_POUCHES,111,184,4,411433,100%
3821,MLB-PARTY_PROPS,143,212,4,411437,100%
3948,MLM-TACTICAL_KNEE_PADS,17,67,4,411441,100%
3988,MLB-LIQUID_HAND_AND_BODY_SOAPS,215,299,4,411445,100%
4068,MLB-GUN_SCOPE_MOUNTS,104,185,4,411449,100%
4137,MLB-SCHOOL_SMOCKS,56,107,4,411453,100%
4168,MLB-INCENSE_HOLDERS,169,301,4,411457,100%
4204,MLB-SALON_FURNITURE_PACKAGES,135,428,4,411461,100%
4228,MLB-FISH_TANK_THERMOSTATS,108,285,4,411465,100%
4356,MLB-TV_SERIES,454,561,4,411469,100%
4396,MLB-JEWELRY_MAKING_KITS,30,62,4,411473,100%
4429,MLB-MOTORCYCLE_IGNITION_SWITCHES,247,330,4,411477,100%
4438,MLB-RECEPTION_DESKS,402,934,4,411481,100%
4446,MLB-MANUAL_TRANSMISSION_SHIFT_LEVER_BOOTS,313,411,4,411485,100%
4454,MLM-PAPER_TOWEL_DISPENSERS,21,28,4,411489,100%
4560,MLB-DOLL_VEHICLES,68,78,4,411493,100%
4718,MLB-BICYCLE_HANDLEBARS,249,435,4,411497,100%
4785,MLB-SCANNERS,81,153,4,411501,100%
4789,MLB-COMBUSTION_OUTBOARD_MOTORS,152,346,4,411505,100%
4799,MLB-CRUTCHES,107,217,4,411509,100%
4805,MLM-SELF_TANNERS,6,12,4,411513,100%
4921,MLB-KITCHEN_POTHOLDERS_AND_OVEN_MITTS,43,61,4,411517,100%
4926,MLM-MINI_BAG_SEALERS,7,30,4,411521,100%
4942,MLB-ELECTRIC_CHAINSAWS,46,135,4,411525,100%
4982,MLB-POPCORN_BOXES,157,293,4,411529,100%
5002,MLB-BABY_TOOTH_BOXES,20,51,4,411533,100%
5225,MLB-RICE_COOKERS,82,189,4,411537,100%
5277,MLB-COLLECTION_DISPLAYS,80,209,4,411541,100%
5318,MLB-MODELISM_BATTERY_CHARGERS,40,36,4,411545,100%
5363,MLB-AMERICAN_FOOTBALL_JERSEYS,128,266,4,411549,100%
5403,MLB-CELLPHONE_AND_TABLET_REPLACEMENT_BUTTONS,60,71,4,411553,100%
5434,MLB-WINDSHIELD_WIPER_ARMS,182,187,4,411557,100%
5435,MLM-SPLINTS,9,29,4,411561,100%
5442,MLB-CANDY_AND_CHOCOLATE_JARS,112,180,4,411565,100%
5543,MLB-JUKEBOXES,41,62,4,411569,100%
5691,MLB-BICYCLE_RACKS,45,65,4,411573,100%
5737,MLB-HAND_TRUCKS,98,168,4,411577,100%
5766,MLB-RESPIRATORS,73,79,4,411581,100%
5972,MLB-BICYCLE_SEAT_COVERS,36,77,4,411585,100%
6050,MLB-BICYCLE_TRAINERS,111,138,4,411589,100%
6093,MLB-FISH_TANK_THERMOMETERS,93,86,4,411593,100%
6102,MLB-GONIOMETERS,8,10,4,411597,100%
6150,MLB-TACTICAL_BAGS_AND_BACKPACKS,107,171,4,411601,100%
6189,MLB-KIDS_EASELS,29,116,4,411605,100%
6303,MLB-BICYCLE_KICKSTANDS,35,52,4,411609,100%
6332,MLB-HOSE_REELS,48,97,4,411613,100%
6366,MLB-MECHANICAL_PENCILS,95,136,4,411617,100%
6457,MLB-REHABILITATION_GYROSCOPE_BALLS,13,23,4,411621,100%
6468,MLB-GARDEN_MACHINE_CARBURETORS,41,38,4,411625,100%
6469,MLB-EYELASH_GLUES,81,184,4,411629,100%
6488,MLB-MASSAGE_STONES,76,114,4,411633,100%
6533,MLB-GPS_ANTENNAS,34,37,4,411637,100%
6563,MLB-SUSPENSION_TRAINERS,53,121,4,411641,100%
6592,MLB-BICYCLE_COVERS,41,34,4,411645,100%
6644,MLB-SHEET_PROTECTORS,73,74,4,411649,100%
6669,MLB-KITCHEN_THERMOMETERS,44,45,4,411653,100%
6802,MLB-BICYCLE_BUGLE_HORNS,22,43,4,411657,100%
7016,MLB-CABLE_TRACKERS,35,57,4,411661,100%
7037,MLB-SAFETY_BARRIER_CHAINS,29,32,4,411665,100%
7068,MLB-BEARING_PULLERS,30,40,4,411669,100%
7220,MLB-PEDALBOARD_CASES,30,42,4,411673,100%
7679,MLB-YOGURTS,6,4,4,411677,100%
38,MLM-BOOTS,86,124,3,411680,100%
83,MLM-DIECAST_VEHICLES,959,1084,3,411683,100%
115,MLM-PUNCHING_BAGS,94,193,3,411686,100%
117,MLM-AUTOMOTIVE_SIDE_VIEW_MIRRORS,371,418,3,411689,100%
159,MLM-TOY_ROBOTS,182,210,3,411692,100%
178,MLM-SPORTS_CONES,33,56,3,411695,100%
179,MLM-BICYCLE_FENDERS,21,36,3,411698,100%
217,MLM-CAMERA_MONOPODS,52,90,3,411701,100%
295,MLM-JUMPSUITS_AND_OVERALLS,228,405,3,411704,100%
310,MLM-COMPUTER_PROCESSORS,193,353,3,411707,100%
360,MLM-WALLPAPERS,161,284,3,411710,100%
362,MLM-SUCTION_CUP_DENT_PULLERS,28,62,3,411713,100%
420,MLM-BASKET_BALLS,70,111,3,411716,100%
449,MLM-MUSICAL_TUNERS,38,87,3,411719,100%
489,MLM-ORTHOPEDIC_WRIST_BRACES,33,41,3,411722,100%
498,MLM-3D_PRINTERS,93,291,3,411725,100%
499,MLM-FOOTBALL_BALLS,134,235,3,411728,100%
547,MLM-MOVIES,364,393,3,411731,100%
558,MLM-DVR_RECORDERS,69,60,3,411734,100%
559,MLM-ELECTRIC_WAFFLE_MAKERS,75,127,3,411737,100%
570,MLM-DRINKING_GLASSES,262,350,3,411740,100%
580,MLM-UPS_BATTERIES,28,56,3,411743,100%
586,MLM-COMICS,235,272,3,411746,100%
613,MLM-PAINT_BRUSHES,62,126,3,411749,100%
685,MLM-SCOOTERS,173,358,3,411752,100%
800,MLM-CUSHIONS,225,365,3,411755,100%
810,MLM-TENTS,146,240,3,411758,100%
873,MLM-BLANK_DISCS,67,87,3,411761,100%
898,MLM-ELECTRIC_HOME_HEATERS,73,125,3,411764,100%
901,MLM-GARDENING_AND_AGRICULTURE_SUBSTRATES,69,95,3,411767,100%
928,MLM-MUSIC_STANDS,21,54,3,411770,100%
1019,MLM-MANICURE_AND_PEDICURE_KITS,42,79,3,411773,100%
1055,MLM-ESOTERIC_PRODUCTS,278,375,3,411776,100%
1069,MLM-PRECISION_SCALES,9,22,3,411779,100%
1086,MLM-AUTOMOTIVE_LIGHTERS,52,129,3,411782,100%
1099,MLM-SAXOPHONES,43,56,3,411785,100%
1111,MLM-MAKEUP_TRAIN_CASES,46,109,3,411788,100%
1166,MLM-SPICES,66,94,3,411791,100%
1182,MLM-AUTOMOTIVE_AIR_FILTERS,87,123,3,411794,100%
1197,MLM-LAPTOP_BRIEFCASES,119,187,3,411797,100%
1211,MLM-HAIRDRESSING_SCISSORS,122,278,3,411800,100%
1216,MLM-CONTINUOUS_LIGHTING,63,73,3,411803,100%
1226,MLM-MICROBLADING_PIGMENTS,13,38,3,411806,100%
1287,MLM-SHORTS,222,398,3,411809,100%
1370,MLM-SOUND_CARDS,22,33,3,411812,100%
1423,MLM-COCKTAIL_SETS,13,33,3,411815,100%
1463,MLM-HABERDASHERY_SUPPLIES,80,105,3,411818,100%
1508,MLM-TEQUILAS,135,250,3,411821,100%
1552,MLM-SHARPENING_STEELS,16,17,3,411824,100%
1602,MLM-GLOVES_AND_MITTENS,85,138,3,411827,100%
1609,MLM-FISHING_PANTS,70,232,3,411830,100%
1616,MLM-PORTABLE_DVD_PLAYERS,23,48,3,411833,100%
1653,MLM-PET_DIAPERS,12,26,3,411836,100%
1678,MLM-ELECTRIC_POTS_SKILLETS_AND_RICE_COOKERS,60,97,3,411839,100%
1693,MLM-PROJECTOR_MOUNTS,10,35,3,411842,100%
1714,MLM-DISC_PACKAGINGS,19,34,3,411845,100%
1783,MLM-MANUAL_HAND_PLANES,23,46,3,411848,100%
1818,MLM-POWER_CORDS,15,19,3,411851,100%
1854,MLM-HYDRO_PNEUMATIC_PUMPS,9,36,3,411854,100%
1881,MLM-BICYCLE_AND_MOTORCYCLE_LOCKS,47,100,3,411857,100%
1885,MLM-FISH_TANK_PUMPS,69,76,3,411860,100%
1886,MLM-MANNEQUINS,58,106,3,411863,100%
2091,MLB-MOTORCYCLE_ENGINE_CAMSHAFTS,168,265,3,411866,100%
2154,MLB-HYDRATION_BLADDERS,16,31,3,411869,100%
2189,MLM-PLUG_ADAPTERS,14,16,3,411872,100%
2284,MLM-BED_AND_CRIB_CANOPIES,27,35,3,411875,100%
2302,MLM-VIDEO_PLAYER_AND_GAME_CONSOLE_STANDS,52,90,3,411878,100%
2446,MLB-MAGAZINES,450,457,3,411881,100%
2468,MLB-AUTOMOTIVE_CLUTCH_KITS,995,1151,3,411884,100%
2478,MLB-BABY_STROLLER_WEATHER_SHIELDS,87,125,3,411887,100%
2495,MLB-AUTOMOTIVE_FRONT_BUMPERS,1772,2546,3,411890,100%
2498,MLM-CAT_SCRATCHERS,33,46,3,411893,100%
2508,MLB-STARTERS,667,714,3,411896,100%
2664,MLB-AUTOMOTIVE_ENGINE_OIL_FILLER_CAPS,255,351,3,411899,100%
2680,MLB-MAKEUP_SPONGES,108,181,3,411902,100%
2681,MLB-POWER_CORDS,197,259,3,411905,100%
2841,MLB-BOARD_FINS,34,85,3,411908,100%
2849,MLM-HEARING_AIDS,16,8,3,411911,100%
2877,MLB-TREADMILLS,418,1019,3,411914,100%
2932,MLB-LUGGAGE_ORGANIZERS,27,51,3,411917,100%
2949,MLM-WRISTWATCH_SCREEN_PROTECTORS,23,40,3,411920,100%
3061,MLB-ANIMALS_AND_PETS,228,351,3,411923,100%
3090,MLM-LIGHTER_FLUIDS,5,5,3,411926,100%
3149,MLB-SHELF_UNITS,294,654,3,411929,100%
3156,MLB-POLYCARBONATE_SHEETS,22,42,3,411932,100%
3189,MLB-SHAKER_BOTTLES,195,417,3,411935,100%
3255,MLB-HERB_GRINDERS,127,259,3,411938,100%
3273,MLB-DRINK_STIRRERS,25,31,3,411941,100%
3306,MLB-TABLET_KEYBOARDS,130,158,3,411944,100%
3445,MLM-BABY_CUPS,24,68,3,411947,100%
3516,MLB-DECORATIVE_TILES_AND_MOSAICS,212,630,3,411950,100%
3600,MLB-DRUM_STANDS,111,184,3,411953,100%
3614,MLM-TRAINING_MASKS,16,43,3,411956,100%
3716,MLM-VOLLEYBALL_KNEE_PADS,23,71,3,411959,100%
3722,MLB-WHEEL_HUBS,391,389,3,411962,100%
3732,MLB-MODELISM_BATTERIES,144,179,3,411965,100%
3764,MLB-KITCHEN_CABINET_ORGANIZERS,263,620,3,411968,100%
3843,MLB-ANTIQUE_TOY_CARS,100,151,3,411971,100%
3884,MLM-BICYCLE_COVERS,4,4,3,411974,100%
4033,MLB-BALLOON_STICKS,63,110,3,411977,100%
4036,MLB-INDUSTRIAL_FUSES,184,184,3,411980,100%
4071,MLB-TIRE_INNER_TUBES,97,178,3,411983,100%
4075,MLM-LIGHT_STANDS,19,48,3,411986,100%
4107,MLB-BICYCLE_CHAIN_LUBRICANTS,83,99,3,411989,100%
4110,MLM-PASTRY_BAGS,15,14,3,411992,100%
4115,MLM-CATS_LITTER,28,26,3,411995,100%
4152,MLB-NAPKIN_HOLDERS,281,416,3,411998,100%
4157,MLB-ELECTRIC_BATHROOM_FAUCETS,82,146,3,412001,100%
4209,MLB-AUTOMOTIVE_ENGINE_MOUNTS,787,807,3,412004,100%
4230,MLM-VACUUM_TUBES,5,19,3,412007,100%
4235,MLB-ALTERNATOR_PULLEYS,67,69,3,412010,100%
4268,MLB-VEHICLE_ENGINE_PISTON_RING_SETS,264,285,3,412013,100%
4284,MLB-AQUARIUM_FILTER_MATERIALS,305,467,3,412016,100%
4302,MLB-COLD_PORCELAIN_CLAYS,77,104,3,412019,100%
4331,MLB-FLUTES,183,248,3,412022,100%
4338,MLB-CAMERA_CLEANING_KITS,49,44,3,412025,100%
4360,MLB-VINYL_FLOORINGS,184,518,3,412028,100%
4480,MLB-INFRARED_AND_BLUETOOTH_ADAPTERS,65,124,3,412031,100%
4486,MLB-CELLPHONE_REPLACEMENT_SPEAKERS,175,203,3,412034,100%
4576,MLB-REFRIGERATORS_AND_FREEZERS_DOOR_HANDLES,47,56,3,412037,100%
4668,MLB-SOAP_HOLDERS,164,234,3,412040,100%
4678,MLB-FURNITURE_DOOR_AND_WINDOW_HINGES,211,239,3,412043,100%
4858,MLB-AUTOMOTIVE_DOOR_LATCHES,273,297,3,412046,100%
4869,MLB-AUTOMOTIVE_INTERIOR_DOOR_HANDLES,164,180,3,412049,100%
4890,MLB-BIRD_FOODS,266,416,3,412052,100%
5037,MLB-TRAILER_HITCH_BALLS,50,66,3,412055,100%
5065,MLM-BARBELL_COLLARS,3,16,3,412058,100%
5102,MLB-SAFETY_GLOVES,119,168,3,412061,100%
5120,MLB-BICYCLE_CHAINS,112,143,3,412064,100%
5124,MLB-PRINTER_HEADS,77,93,3,412067,100%
5135,MLM-PET_SANITARY_SHOVELS,5,4,3,412070,100%
5184,MLB-EDIBLE_PAPERS,111,187,3,412073,100%
5223,MLB-SALT,135,210,3,412076,100%
5234,MLB-REFRIGERATOR_CRISPER_DRAWER_COVERS,92,123,3,412079,100%
5283,MLB-BASKET_BALLS,95,148,3,412082,100%
5335,MLB-FLATWARE_ORGANIZERS,120,207,3,412085,100%
5359,MLB-STOVETOP_GRILLS,128,207,3,412088,100%
5365,MLB-DISC_PACKAGINGS,58,46,3,412091,100%
5443,MLB-ELECTRIC_POTS_AND_SKILLETS,53,87,3,412094,100%
5446,MLB-JUICES,90,106,3,412097,100%
5463,MLB-ELECTRIC_GUN_GLUE_STICKS,31,50,3,412100,100%
5464,MLB-FISH_TANK_WAVE_MAKERS,62,321,3,412103,100%
5480,MLB-PAPER_TOWEL_DISPENSERS,62,94,3,412106,100%
5494,MLB-CONSTRUCTION_PUMPS,112,189,3,412109,100%
5532,MLB-LENS_ADAPTER_RINGS,61,121,3,412112,100%
5592,MLB-YOGA_MATS,60,126,3,412115,100%
5604,MLB-MOTORCYCLE_JERSEYS,148,234,3,412118,100%
5633,MLB-SLATWALL_PANELS,83,195,3,412121,100%
5645,MLB-AUTOMOTIVE_INTERIOR_REARVIEW_MIRRORS,109,141,3,412124,100%
5681,MLB-SIM_CARD_TRAYS,60,76,3,412127,100%
5782,MLB-SPORT_HEADBANDS,36,75,3,412130,100%
5798,MLB-FETAL_DOPPLERS,72,96,3,412133,100%
5815,MLB-CABLE_ORGANIZERS,59,64,3,412136,100%
5826,MLB-BOOMBOXES,70,123,3,412139,100%
5846,MLB-BONGS,87,150,3,412142,100%
5858,MLB-TABLE_TENNIS_BALLS,58,62,3,412145,100%
5908,MLB-AUTOMOTIVE_SEAT_BELT_COVERS,58,85,3,412148,100%
5923,MLB-MACHINE_AND_TOOL_PLANS,40,58,3,412151,100%
6129,MLB-PEGBOARDS_TOOL_STORAGE,44,138,3,412154,100%
6210,MLB-NAIL_STAMPING_PLATES,84,181,3,412157,100%
6215,MLB-TOY_SEWING_MACHINES,35,125,3,412160,100%
6219,MLB-WHEEL_STUDS,76,106,3,412163,100%
6248,MLB-MICROMETERS,72,72,3,412166,100%
6261,MLB-STAPLERS,36,63,3,412169,100%
6262,MLB-GRADUATED_CYLINDERS,11,10,3,412172,100%
6301,MLB-HOOD_LOCKS,174,200,3,412175,100%
6314,MLB-AUTOMOTIVE_WINDOW_CRANK_HANDLES,51,57,3,412178,100%
6348,MLB-PILL_BOXES,26,22,3,412181,100%
6368,MLB-BREAD_BASKETS_AND_BOXES,45,76,3,412184,100%
6380,MLB-CONDUCTIVITY_METERS,24,53,3,412187,100%
6384,MLB-WASHING_MACHINE_DRUM_SPIDERS,37,60,3,412190,100%
6482,MLB-BADGE_AND_CARD_HOLDERS,43,36,3,412193,100%
6483,MLB-SEWING_KITS,41,66,3,412196,100%
6541,MLB-AFTERSHAVES,64,97,3,412199,100%
6572,MLB-TOY_BOWS_AND_ARROWS,38,57,3,412202,100%
6616,MLB-REPELLENT_BRACELETS,15,31,3,412205,100%
6642,MLM-ELECTRIC_MENSTRUAL_CUP_STERILIZERS,1,18,3,412208,100%
6666,MLM-SCHOOL_SMOCKS,2,6,3,412211,100%
6674,MLB-GAUZES,61,48,3,412214,100%
6726,MLB-BICYCLE_TIRE_SEALANTS,29,45,3,412217,100%
6766,MLB-PUSH_UP_BARS,32,45,3,412220,100%
6803,MLB-PET_TRAINING_CLICKERS,12,21,3,412223,100%
6815,MLB-CELLPHONE_CAMERA_PROTECTORS,31,73,3,412226,100%
6894,MLB-MICROBLADING_RINGS,10,10,3,412229,100%
6942,MLB-SOUND_LEVEL_METERS,11,12,3,412232,100%
7056,MLB-CODING_MACHINES,13,27,3,412235,100%
7131,MLB-PROTOBOARDS,25,39,3,412238,100%
7143,MLB-ANEMOMETERS,14,17,3,412241,100%
7186,MLB-DRAIN_TRAPS,82,148,3,412244,100%
7212,MLB-ELECTRIC_KNIVES,20,47,3,412247,100%
7277,MLB-TANNING_ADHESIVE_BIKINIS_AND_TAPES,24,39,3,412250,100%
7309,MLB-INDUSTRIAL_MACHINE_REMOTE_CONTROLS,2,12,3,412253,100%
7328,MLB-DOG_TRAINING_WHISTLES,17,32,3,412256,100%
7384,MLB-CHALKBOARD_AND_WHITEBOARD_ERASERS,27,24,3,412259,100%
7548,MLB-BABY_SHOWER_VISORS,13,21,3,412262,100%
35,MLM-AIRSOFT_GUNS,644,1493,2,412264,100%
78,MLM-FISHING_LURES,129,193,2,412266,100%
85,MLM-DECORATIVE_PAINTINGS,615,955,2,412268,100%
151,MLM-ANTI_SNORE_CHIN_STRAPS,15,26,2,412270,100%
176,MLM-AUDIO_AND_VIDEO_CONNECTORS,183,173,2,412272,100%
189,MLM-MASCARAS,134,238,2,412274,100%
192,MLM-SOFAS,366,734,2,412276,100%
246,MLM-HAIR_BRUSHES,62,70,2,412278,100%
249,MLM-AUTOMOTIVE_WHEEL_NUT_COVERS,318,423,2,412280,100%
293,MLM-NOTEBOOKS_AND_WRITING_PADS,242,403,2,412282,100%
294,MLM-COOKING_OILS,68,87,2,412284,100%
339,MLM-CAMERAS,485,726,2,412286,100%
378,MLM-PET_JACKETS_AND_COATS,60,135,2,412288,100%
401,MLM-AUTOMOTIVE_MANUAL_TRANSMISSION_SHIFT_LEVERS,182,219,2,412290,100%
424,MLM-ROLLER_SKATES,176,205,2,412292,100%
443,MLM-JEWELRY,232,268,2,412294,100%
448,MLM-MOTORCYCLE_REARVIEW_MIRRORS,97,105,2,412296,100%
457,MLM-MAKEUP_SPONGES,20,23,2,412298,100%
480,MLM-CHARCOAL_GRILLS,143,255,2,412300,100%
481,MLM-SHADE_CLOTHS,55,113,2,412302,100%
509,MLM-CUPCAKE_STANDS,64,95,2,412304,100%
530,MLM-JUICERS,69,141,2,412306,100%
553,MLM-DEEP_FRYERS,130,227,2,412308,100%
562,MLM-VEGETABLES_AND_FRUITS_CHOPPERS,36,87,2,412310,100%
564,MLM-CAR_SPOILERS,156,243,2,412312,100%
565,MLM-WET_BABY_WIPES,48,73,2,412314,100%
577,MLM-PARKING_SENSORS,37,74,2,412316,100%
582,MLM-TOY_PLANES,64,85,2,412318,100%
585,MLM-AMERICAN_FOOTBALL_JERSEYS,129,152,2,412320,100%
606,MLM-AUTOMOTIVE_SUN_VISORS,66,75,2,412322,100%
646,MLM-BICYCLE_SEATS,58,94,2,412324,100%
675,MLM-CAT_AND_DOG_DRINKERS_AND_FEEDERS,95,140,2,412326,100%
680,MLM-NAIL_POWDERS,115,174,2,412328,100%
695,MLM-TOY_BUILDING_SETS,730,792,2,412330,100%
699,MLM-MOTORCYCLE_CARBURETORS,87,133,2,412332,100%
701,MLM-SOAP_AND_DETERGENT_DISPENSERS,47,63,2,412334,100%
726,MLM-OXIMETERS,37,57,2,412336,100%
728,MLM-REUSABLE_MASKS,21,34,2,412338,100%
735,MLM-HAIRDRESSING_ACCESSORIES,74,102,2,412340,100%
745,MLM-BIRD_FOODS,38,31,2,412342,100%
769,MLM-FEMALE_URINATION_DEVICES,27,26,2,412344,100%
799,MLM-GYM_HANDLES,29,89,2,412346,100%
802,MLM-GUN_SCOPE_MOUNTS,43,40,2,412348,100%
843,MLM-AUTOMOTIVE_FENDER_FLARES,106,154,2,412350,100%
881,MLM-AUTOMOTIVE_TAIL_LIGHTS,382,464,2,412352,100%
905,MLM-PHOTOGRAPHY_BACKDROPS,53,84,2,412354,100%
921,MLM-FIRE_STARTER_FLINTS,25,75,2,412356,100%
950,MLM-ARTIFICIAL_FLOWERS,74,144,2,412358,100%
973,MLM-CHOCOLATES,178,235,2,412360,100%
975,MLM-COINS,288,304,2,412362,100%
1054,MLM-SPORT_COLLECTIBLES,183,229,2,412364,100%
1064,MLM-BLENDER_JARS,25,35,2,412366,100%
1066,MLM-FOOD_VACUUM_SEALERS,6,5,2,412368,100%
1081,MLM-CRIBS,84,187,2,412370,100%
1118,MLM-DEPILATORY_CREAMS,27,38,2,412372,100%
1125,MLM-THERMAL_CUPS_AND_TUMBLERS,13,39,2,412374,100%
1132,MLM-BABY_BOUNCERS,71,112,2,412376,100%
1138,MLM-DARTS,52,74,2,412378,100%
1148,MLM-MIXERS,114,156,2,412380,100%
1221,MLM-BABY_BOTTLES,131,227,2,412382,100%
1228,MLM-EXFOLIATING_GLOVES,2,4,2,412384,100%
1260,MLM-AUTOMODELISM_VEHICLES,77,83,2,412386,100%
1357,MLM-AUTOMOTIVE_PEDALS,73,80,2,412388,100%
1376,MLM-CLOCKS_ACCESSORIES_AND_SPARE_PARTS,54,82,2,412390,100%
1382,MLM-MOTORCYCLE_INTERCOMMUNICATORS,63,75,2,412392,100%
1388,MLM-BABY_CLOTHING,108,195,2,412394,100%
1389,MLM-NIGHTGOWNS,28,45,2,412396,100%
1413,MLM-MARKING_AND_WARNING_TAPES,14,11,2,412398,100%
1424,MLM-CELLPHONE_PRINTERS,22,97,2,412400,100%
1454,MLM-AUTOMOTIVE_COOLANT_RESERVOIRS,86,119,2,412402,100%
1457,MLM-COMPUTER_AND_TV_FLEX_CABLES,33,31,2,412404,100%
1467,MLM-STYLUSES,87,137,2,412406,100%
1498,MLM-CAMERA_FLASHES,94,136,2,412408,100%
1587,MLM-PUPPETS,13,13,2,412410,100%
1635,MLM-BEAUTY_APPLIANCES,41,66,2,412412,100%
1744,MLM-HYGROMETERS,19,23,2,412414,100%
1784,MLM-TV_REMOTE_CONTROL_COVERS,4,0,2,412416,100%
1803,MLM-TOY_BUBBLE_BLOWERS,26,38,2,412418,100%
1828,MLM-VASES,89,123,2,412420,100%
1837,MLM-DOOR_AND_STAIR_SAFETY_FENCES,21,20,2,412422,100%
1856,MLM-VOLTAGE_REGULATORS,22,29,2,412424,100%
1918,MLM-VISES,20,26,2,412426,100%
1928,MLM-STRING_INSTRUMENT_CAPOS,19,30,2,412428,100%
1990,MLM-HAND_POLISHERS,38,52,2,412430,100%
2013,MLB-KITCHEN_KNIVES,105,156,2,412432,100%
2076,MLB-CAR_WHEELS,4817,6834,2,412434,100%
2096,MLB-FERTILE_BIRD_EGGS,596,1894,2,412436,100%
2127,MLM-FIDGET_SPINNERS,43,74,2,412438,100%
2237,MLM-PORTABLE_GAME_CONSOLE_BATTERIES,6,13,2,412440,100%
2262,MLM-APERITIFS,7,8,2,412442,100%
2308,MLM-MANUAL_GRAIN_MILLS,9,9,2,412444,100%
2312,MLB-TELEVISION_MAIN_PLATE_REPLACEMENTS,866,971,2,412446,100%
2323,MLM-MEGAPHONES,27,72,2,412448,100%
2349,MLB-BLANKETS,336,604,2,412450,100%
2440,MLB-THERMAL_CAN_AND_BOTTLE_HOLDERS,189,323,2,412452,100%
2476,MLB-AUTOMOTIVE_OIL_PUMPS,253,317,2,412454,100%
2492,MLB-COOKIES,140,213,2,412456,100%
2505,MLB-TAPE_MEASURES,95,141,2,412458,100%
2510,MLB-DEFROSTING_TRAYS,35,58,2,412460,100%
2579,MLM-FLAVORED_WATERS,7,14,2,412462,100%
2608,MLM-AIRBAG_MODULES,4,12,2,412464,100%
2616,MLM-MICROSCOPES,67,84,2,412466,100%
2624,MLB-DINING_TABLES,1341,2683,2,412468,100%
2730,MLB-GUN_CLEANING_KITS,83,143,2,412470,100%
2741,MLB-AUTOMOTIVE_BUMPER_GRILLES,493,552,2,412472,100%
2746,MLB-BEER_FAUCETS,70,108,2,412474,100%
2795,MLB-WINDSHIELD_WIPER_SWITCHES,101,112,2,412476,100%
2796,MLB-BINDING_COVERS,19,37,2,412478,100%
2806,MLB-DECORATIVE_PLATES,86,111,2,412480,100%
2838,MLB-LAUNDRY_DETERGENTS,118,135,2,412482,100%
2865,MLM-MOTORCYCLE_KNEE_PADS,29,82,2,412484,100%
2906,MLB-ENGINE_OILS,935,1299,2,412486,100%
2955,MLB-GEOMETRY_RULERS_PROTRACTORS_AND_SET_SQUARES,121,134,2,412488,100%
2976,MLB-POWERED_RIDE_ON_TOYS,467,1073,2,412490,100%
3112,MLM-CRAFT_MOLDS,9,7,2,412492,100%
3160,MLB-GUITAR_PEGS,167,232,2,412494,100%
3173,MLM-CAR_TINTED_GLASSES,12,57,2,412496,100%
3197,MLM-TEMPERAS,9,6,2,412498,100%
3217,MLM-ICE_CREAM_MACHINES,25,75,2,412500,100%
3247,MLB-WATER_RADIATORS,287,339,2,412502,100%
3248,MLB-CATS,291,426,2,412504,100%
3265,MLB-AUTOMOTIVE_PEDALS,587,667,2,412506,100%
3285,MLM-AUTOMOTIVE_BLOW_OFF_VALVES,17,21,2,412508,100%
3379,MLB-GUN_AMMUNITION_MAGAZINES,95,129,2,412510,100%
3389,MLB-PIPES_AND_TUBES,165,331,2,412512,100%
3408,MLB-CUTTING_PLOTTERS,47,111,2,412514,100%
3452,MLM-ELECTRIC_STAPLERS_AND_BRAD_NAILERS,34,52,2,412516,100%
3454,MLB-BABY_CUPS,298,535,2,412518,100%
3483,MLM-COMPRESSION_SOCKS,7,6,2,412520,100%
3507,MLB-ROOF_TILES,580,1544,2,412522,100%
3510,MLM-REPELLENT_BRACELETS,16,29,2,412524,100%
3517,MLB-VACUUM_PUMPS,98,155,2,412526,100%
3532,MLB-SUMP_GUARDS,105,105,2,412528,100%
3554,MLB-SHOWER_CURTAINS,121,227,2,412530,100%
3608,MLB-JOKE_TOYS,98,156,2,412532,100%
3681,MLB-CAR_AV_RECEIVERS,211,553,2,412534,100%
3729,MLB-HORSE_REINS,211,240,2,412536,100%
3761,MLB-BICYCLE_GROUPSETS,403,643,2,412538,100%
3763,MLB-CACHACAS,268,319,2,412540,100%
3778,MLM-HANDBAG_ORGANIZERS,23,49,2,412542,100%
3808,MLB-DRUM_PRACTICE_PADS,37,66,2,412544,100%
3811,MLB-MOTORCYCLE_PANTS,207,349,2,412546,100%
3815,MLB-SCALEXTRIC_TRACKS,61,100,2,412548,100%
3849,MLB-BICYCLE_PEDAL_CLEATS,25,52,2,412550,100%
3891,MLB-WASHING_MACHINE_DRAIN_PUMPS,76,112,2,412552,100%
3946,MLB-HOSPITAL_BEDS,82,152,2,412554,100%
3952,MLM-BALLOONS_GRIDS,3,42,2,412556,100%
3998,MLB-OFFICE_STORAGE_CABINETS,289,473,2,412558,100%
4016,MLB-HOME_BOTTLE_STANDS,74,109,2,412560,100%
4018,MLB-CONDOMS,207,429,2,412562,100%
4062,MLB-AUTOMOTIVE_MOLDINGS,507,621,2,412564,100%
4063,MLB-PET_TAGS,88,138,2,412566,100%
4088,MLM-BLEACHES,6,8,2,412568,100%
4131,MLB-HORSE_BLANKETS,118,172,2,412570,100%
4158,MLB-ENGINE_CYLINDER_HEAD_BOLTS,118,182,2,412572,100%
4167,MLM-TACTICAL_HANDCUFFS,15,28,2,412574,100%
4180,MLB-MINI_BAG_SEALERS,9,13,2,412576,100%
4202,MLB-YOGURT_MAKERS,33,49,2,412578,100%
4226,MLB-AUTOMOTIVE_RADIATOR_HOSES,181,191,2,412580,100%
4229,MLB-CAR_TURN_SIGNAL_LIGHTS,595,869,2,412582,100%
4245,MLB-AUTOMOTIVE_FLEX_FUEL_CONVERTERS,67,80,2,412584,100%
4246,MLB-TORSION_BARS,116,104,2,412586,100%
4301,MLB-COAT_RACKS,67,100,2,412588,100%
4405,MLM-DISHWASHING_DETERGENTS,12,15,2,412590,100%
4425,MLB-LUNCHBOXES,107,123,2,412592,100%
4483,MLB-SHIN_GUARDS,86,147,2,412594,100%
4498,MLB-BROOCHES,65,113,2,412596,100%
4503,MLM-VEHICLE_TRAILER_CONNECTORS,5,11,2,412598,100%
4505,MLB-FOOTBALL_JACKETS,198,233,2,412600,100%
4601,MLB-MINERAL_WATERS,46,64,2,412602,100%
4602,MLB-BABY_CHANGING_PADS,33,45,2,412604,100%
4612,MLM-BRUSH_CUTTERS,3,7,2,412606,100%
4641,MLM-HABERDASHERY_EYELETS,9,20,2,412608,100%
4647,MLB-DRUMSTICKS_MALLETS_AND_BRUSHES,159,183,2,412610,100%
4675,MLB-WASHING_MACHINE_HOSES,80,93,2,412612,100%
4695,MLB-VIDEO_PLAYER_REMOTE_CONTROLS,123,139,2,412614,100%
4702,MLB-PENIS_RINGS,110,180,2,412616,100%
4822,MLB-PAINT_MIXERS,51,110,2,412618,100%
4839,MLB-HOT_FOOD_DISPLAY_CASES,91,181,2,412620,100%
4866,MLB-LASER_PRINTER_DRUMS,82,88,2,412622,100%
4891,MLB-BUTTSTOCKS,181,221,2,412624,100%
4939,MLB-BICYCLE_RIMS,246,380,2,412626,100%
4977,MLB-SHARPENING_STEELS,35,41,2,412628,100%
5020,MLB-MOTORCYCLE_HANDGUARDS,139,197,2,412630,100%
5045,MLB-CONTACT_LENS_CLEANING_SOLUTIONS,44,117,2,412632,100%
5051,MLB-AUTOMOTIVE_PERFORMANCE_CHIPS,241,315,2,412634,100%
5057,MLB-LAUNDRY_WASH_BAGS,28,15,2,412636,100%
5084,MLB-FIDGET_SPINNERS,107,176,2,412638,100%
5099,MLB-MORTAR_MUDDLERS,7,15,2,412640,100%
5188,MLB-TAROT_CARDS,43,36,2,412642,100%
5190,MLB-POOL_CHEMICAL_TEST_KITS,47,81,2,412644,100%
5199,MLB-PET_CLIPPER_REPLACEMENT_BLADES,52,82,2,412646,100%
5207,MLB-SCHOOL_AND_OFFICE_ENVELOPES,99,144,2,412648,100%
5249,MLB-BABY_KNEE_PADS,25,51,2,412650,100%
5255,MLB-PET_ULTRASONIC_REPELLENTS,29,27,2,412652,100%
5279,MLB-POOL_FILTERS,73,138,2,412654,100%
5295,MLB-PREAMPLIFIERS,132,209,2,412656,100%
5296,MLB-ANTI_DECUBITUS_MATTRESSES,41,80,2,412658,100%
5314,MLB-LONGBOARDS,87,207,2,412660,100%
5337,MLB-ANGLE_CLAMPS,45,78,2,412662,100%
5352,MLB-HACKSAW_BLADES,164,207,2,412664,100%
5353,MLB-VINEGARS,28,43,2,412666,100%
5369,MLB-FENCE_CHARGERS,12,30,2,412668,100%
5387,MLB-THERMAL_TAPES,24,14,2,412670,100%
5415,MLM-PREGNANCY_BELTS,5,18,2,412672,100%
5423,MLB-SLATWALL_PANEL_SUPPORTS,80,106,2,412674,100%
5466,MLB-SLIPPERS,206,244,2,412676,100%
5474,MLB-THICKNESS_GAUGES,24,50,2,412678,100%
5482,MLB-TOOL_ORGANIZERS,82,181,2,412680,100%
5603,MLB-GUITAR_STRAPS,128,107,2,412682,100%
5623,MLB-CELLPHONE_BATTERY_CASES,77,119,2,412684,100%
5644,MLB-PUPPETS,106,117,2,412686,100%
5663,MLB-FLASH_TRIGGERS,33,42,2,412688,100%
5690,MLB-MODELISM_SERVO_MOTORS,81,115,2,412690,100%
5697,MLB-FOOTBALL_GOALS,68,182,2,412692,100%
5698,MLB-CHOCOLATE_WATERFALLS,45,91,2,412694,100%
5765,MLB-AUTOMOTIVE_BRAKE_CALIPERS,117,124,2,412696,100%
5800,MLB-HOT_WATER_BOTTLES,61,74,2,412698,100%
5835,MLB-MAGNETIC_COMPASSES,96,192,2,412700,100%
5851,MLB-DRUM_THRONES,21,22,2,412702,100%
5852,MLB-DECORATIVE_WIND_CHIMES,111,181,2,412704,100%
5920,MLB-HANDBAG_ORGANIZERS,32,56,2,412706,100%
5966,MLB-ULTRASONIC_CAVITATION_MACHINES,68,177,2,412708,100%
5997,MLB-INTIMATE_SOAPS,110,302,2,412710,100%
6010,MLB-INTERNAL_LAPTOP_COOLING_FANS,81,86,2,412712,100%
6013,MLB-FREEZER_BAGS,46,64,2,412714,100%
6106,MLM-DRINKING_GLASS_RIMMERS,2,2,2,412716,100%
6113,MLB-SHAVING_CREAMS,100,157,2,412718,100%
6124,MLB-PINCERS,58,93,2,412720,100%
6136,MLB-ELECTRIC_DEMOLITION_HAMMERS,23,61,2,412722,100%
6230,MLB-AUTOMOTIVE_FENDER_FLARES,77,84,2,412724,100%
6275,MLB-GARDEN_TORCHES,33,23,2,412726,100%
6289,MLB-AUTOMOTIVE_SPARE_TIRE_SUPPORTS,60,144,2,412728,100%
6317,MLB-SWIMMING_FINS,49,73,2,412730,100%
6321,MLB-TOY_TRAINS,119,219,2,412732,100%
6378,MLB-REFRIGERATOR_AND_FREEZER_HEATERS,49,75,2,412734,100%
6463,MLB-SPARKLING_WATER_MAKERS,12,42,2,412736,100%
6499,MLB-ORTHOPEDIC_WRIST_BRACES,63,119,2,412738,100%
6568,MLB-AUTOMOTIVE_LICENSE_PLATE_BRACKETS,63,133,2,412740,100%
6721,MLB-MEDICAL_EXAM_TABLES,10,8,2,412742,100%
6767,MLB-CAR_AC_RECEIVER_DRIERS,87,149,2,412744,100%
6797,MLB-EGG_HOLDERS,25,29,2,412746,100%
6807,MLB-GRATED_COCONUT,6,9,2,412748,100%
6811,MLB-CONSTRUCTION_TILE_GROUTS,25,62,2,412750,100%
6813,MLB-GPS_CASES_AND_COVERS,36,75,2,412752,100%
6839,MLB-HAND_FANS,27,36,2,412754,100%
6856,MLB-CASH_REGISTERS,33,89,2,412756,100%
6864,MLB-SCREEN_SEPARATOR_MACHINES,25,52,2,412758,100%
6906,MLB-ELECTRIC_DEHUMIDIFIERS,58,99,2,412760,100%
6939,MLB-REPTILE_AND_AMPHIBIAN_TERRARIUM_LIGHT_BULBS,27,132,2,412762,100%
6976,MLB-BABY_STERILIZERS,24,52,2,412764,100%
7004,MLB-CRYOLIPOLYSIS_MACHINES,31,102,2,412766,100%
7047,MLB-MATE_STRAWS,36,52,2,412768,100%
7159,MLB-BICYCLE_CHAIN_CLEANERS,18,132,2,412770,100%
7214,MLB-SURFBOARD_WAXES,6,6,2,412772,100%
7219,MLB-KITCHEN_SYRINGES,16,11,2,412774,100%
7229,MLB-PEANUT_BUTTERS,13,38,2,412776,100%
7244,MLB-NECK_GAITERS_MASKS_AND_BALACLAVAS,29,67,2,412778,100%
7260,MLB-EDIBLE_SEAWEEDS,22,37,2,412780,100%
7362,MLB-SIM_CARD_CUTTERS,6,13,2,412782,100%
7633,MLB-PASTA_DRYING_RACKS,6,16,2,412784,100%
7812,MLB-SAVORY_PIES,5,2,2,412786,100%
45,MLM-ELECTRIC_GUITARS,353,406,1,412787,100%
143,MLM-AUTOMOTIVE_POWER_WINDOW_REGULATORS,36,58,1,412788,100%
226,MLM-VACUUM_PUMPS,16,18,1,412789,100%
228,MLM-TOOL_ACCESSORIES_AND_SPARES,312,448,1,412790,100%
240,MLM-ORTHOPEDICS,63,110,1,412791,100%
256,MLM-POPCORN_MACHINES,43,89,1,412792,100%
257,MLM-BASEBALL_AND_SOFTBALL_FIELDING_GLOVES,163,193,1,412793,100%
307,MLM-PANTYHOSE,95,114,1,412794,100%
337,MLM-SOIL_FERTILIZERS,42,62,1,412795,100%
347,MLM-ALL_IN_ONE,165,207,1,412796,100%
374,MLM-BALL_PIT_BALLS,18,29,1,412797,100%
386,MLM-AUTOMOTIVE_BATTERIES,126,151,1,412798,100%
396,MLM-EMBROIDERY_MACHINES,30,40,1,412799,100%
408,MLM-WINES,60,84,1,412800,100%
421,MLM-GUN_HOLSTERS,98,153,1,412801,100%
439,MLM-NAIL_ART_BRUSHES,67,102,1,412802,100%
444,MLM-GAS_LIFT_SUPPORTS,62,61,1,412803,100%
493,MLM-CUT_OFF_AND_GRINDING_WHEELS,75,77,1,412804,100%
512,MLM-SCREEN_PRINTING_MACHINES,31,35,1,412805,100%
533,MLM-SHOWER_CADDIES,72,171,1,412806,100%
557,MLM-PADLOCKS,163,252,1,412807,100%
561,MLM-AUTOMOTIVE_BUMPER_GRILLES,399,444,1,412808,100%
584,MLM-CLEANING_SUPPLIES,125,171,1,412809,100%
597,MLM-HOVERBOARDS,71,87,1,412810,100%
608,MLM-POSTERS,160,200,1,412811,100%
610,MLM-SCHOOL_KITS,14,25,1,412812,100%
643,MLM-AM_FM_RADIOS,43,52,1,412813,100%
670,MLM-PUZZLES,256,358,1,412814,100%
672,MLM-CYCLING_COMPUTERS,31,51,1,412815,100%
677,MLM-POWER_STRIPS,82,126,1,412816,100%
687,MLM-ITEM_FINDERS,14,47,1,412817,100%
708,MLM-PROJECTOR_SCREENS,75,123,1,412818,100%
711,MLM-OFFICE_EQUIPMENT,227,267,1,412819,100%
731,MLM-AUTOMOTIVE_MOLDINGS,325,401,1,412820,100%
743,MLM-CAMERA_BACKPACKS,44,82,1,412821,100%
748,MLM-CAMERA_STRAPS,55,101,1,412822,100%
754,MLM-MOTORCYCLE_TURN_SIGNAL_LIGHTS,63,92,1,412823,100%
758,MLM-PINATAS,36,46,1,412824,100%
778,MLM-AUTOMOTIVE_SUSPENSION_CONTROL_ARMS,86,89,1,412825,100%
794,MLM-INDUSTRIAL_COFFEE_MAKERS,65,97,1,412826,100%
795,MLM-MARTIAL_ARTS_CHEST_GUARDS,39,59,1,412827,100%
823,MLM-AUTOMOTIVE_WHEEL_COVERS,79,90,1,412828,100%
824,MLM-PORTABLE_GAME_CONSOLE_POWER_SUPPLIES,20,22,1,412829,100%
829,MLM-TV_ANTENNAS,107,147,1,412830,100%
855,MLM-AUTOMOTIVE_LIGHT_SWITCHES,88,121,1,412831,100%
857,MLM-BAR_CLAMPS,25,34,1,412832,100%
865,MLM-POOL_INFLATABLES,123,159,1,412833,100%
868,MLM-KITCHEN_WHISKS,15,25,1,412834,100%
891,MLM-PORTABLE_GENERATORS,108,130,1,412835,100%
903,MLM-DEFENSE_KNUCKLES,50,67,1,412836,100%
904,MLM-DOG_HARNESSES,107,208,1,412837,100%
906,MLM-WASTE_BASKETS,46,58,1,412838,100%
927,MLM-FLATWARE_SETS,95,154,1,412839,100%
956,MLM-DOLL_CLOTHES,52,48,1,412840,100%
969,MLM-HOME_FURNITURE,255,286,1,412841,100%
974,MLM-DISPOSABLE_CUPS,75,89,1,412842,100%
981,MLM-NETWORK_SWITCHES,75,125,1,412843,100%
1017,MLM-CONCEALERS,73,94,1,412844,100%
1022,MLM-ORGANIZER_CABINETS_AND_BOXES,11,29,1,412845,100%
1032,MLM-AUDIO_AMPLIFIERS,189,245,1,412846,100%
1033,MLM-DJ_CONTROLLERS,96,116,1,412847,100%
1045,MLM-REPTILE_AND_AMPHIBIAN_TERRARIUM_LIGHT_BULBS,23,21,1,412848,100%
1057,MLM-MULTIGAME_MACHINE_CARDS,12,13,1,412849,100%
1065,MLM-PORTABLE_EVAPORATIVE_AIR_COOLERS,35,75,1,412850,100%
1072,MLM-CRIMPING_PLIERS,44,65,1,412851,100%
1102,MLM-MOTORCYCLE_SEATS,34,44,1,412852,100%
1108,MLM-AUTOMOTIVE_IDLE_AIR_CONTROL_VALVES,49,56,1,412853,100%
1117,MLM-GUITAR_PICKUPS,47,65,1,412854,100%
1121,MLM-IMPACT_WRENCHES,66,111,1,412855,100%
1157,MLM-SYNTHETIC_GRASS,30,50,1,412856,100%
1183,MLM-BRAKE_LIGHTS,58,128,1,412857,100%
1275,MLM-COUNTERFEIT_MONEY_DETECTOR_MACHINE,8,22,1,412858,100%
1280,MLM-MOTORCYCLE_HANDLEBARS,45,40,1,412859,100%
1292,MLM-INDUSTRIAL_COOKING_OVENS,69,118,1,412860,100%
1298,MLM-TABLET_KEYBOARDS,107,155,1,412861,100%
1304,MLM-AUTOMOTIVE_EXHAUST_CATALYTICS,86,102,1,412862,100%
1307,MLM-RECTIFIER_DIODES,75,104,1,412863,100%
1312,MLM-MOTORCYCLE_HANDLEBAR_GRIPS,83,99,1,412864,100%
1319,MLM-ORTHOPEDIC_WALKER_BOOTS,25,21,1,412865,100%
1363,MLM-SAUCES_AND_DRESSINGS,63,103,1,412866,100%
1377,MLM-ELECTRIC_INSECT_RACKETS,17,35,1,412867,100%
1406,MLM-BABY_CAR_SEATS,91,146,1,412868,100%
1436,MLM-WATER_PURIFIERS_FILTERS,117,101,1,412869,100%
1444,MLM-AUTOMOTIVE_CHROME_TRIMS,62,51,1,412870,100%
1464,MLM-MULTIPURPOSE_CLEANERS_AND_DISINFECTANTS,50,71,1,412871,100%
1473,MLM-SARONGS,72,152,1,412872,100%
1474,MLM-MEMORY_CARD_READERS,30,33,1,412873,100%
1478,MLM-SHOELACES,35,79,1,412874,100%
1488,MLM-CUFFLINKS,56,47,1,412875,100%
1521,MLM-ROTARY_TATTOO_MACHINES,25,50,1,412876,100%
1547,MLM-ELECTRONIC_LOCKS,40,62,1,412877,100%
1550,MLM-MANUAL_MASSAGERS,37,75,1,412878,100%
1551,MLM-DRIED_FRUITS,68,73,1,412879,100%
1560,MLB-STORAGE_DRAWERS,149,352,1,412880,100%
1579,MLB-WINDSHIELD_WIPER_MOTORS,221,242,1,412881,100%
1617,MLM-AUTOMOTIVE_RUST_INHIBITORS,39,68,1,412882,100%
1623,MLM-LASER_MEASURES,33,70,1,412883,100%
1644,MLM-SUN_UMBRELLAS,58,112,1,412884,100%
1658,MLM-BLENDER_BLADES,13,15,1,412885,100%
1679,MLM-POINTS_OF_SALE_KITS,15,54,1,412886,100%
1702,MLM-NAIL_STICKERS,40,57,1,412887,100%
1705,MLM-TATTOO_KITS,17,26,1,412888,100%
1711,MLM-GAME_CONSOLE_SCREEN_PROTECTORS,14,27,1,412889,100%
1725,MLM-LUMBAR_AND_ABDOMINAL_BRACES,53,65,1,412890,100%
1745,MLM-FACE_POWDERS,55,90,1,412891,100%
1747,MLM-SUNBATHING_CHAIRS,27,50,1,412892,100%
1751,MLB-TOILET_TANKS,187,224,1,412893,100%
1792,MLM-PET_TAGS,25,33,1,412894,100%
1806,MLM-MANICURE_PRACTICE_HANDS_AND_FINGERS,29,47,1,412895,100%
1811,MLM-SALT,41,50,1,412896,100%
1815,MLM-ANTI_STATIC_WRIST_STRAPS,9,10,1,412897,100%
1823,MLM-LIP_GLOSSES,63,124,1,412898,100%
1864,MLM-KIDS_WALKIE_TALKIES,10,23,1,412899,100%
1944,MLM-AUTOMOTIVE_ANGEL_EYES,45,119,1,412900,100%
1975,MLB-EGR_VALVES,52,46,1,412901,100%
1977,MLM-MAKEUP_REMOVERS,35,48,1,412902,100%
1982,MLM-AIR_COMPRESSOR_PUMPS,12,9,1,412903,100%
1984,MLM-BABY_MONITORS,29,31,1,412904,100%
2010,MLB-AUTOMOBILE_FENDER_LINERS,297,336,1,412905,100%
2023,MLB-VEHICLE_BRAKE_DISCS,798,1036,1,412906,100%
2032,MLB-INSTRUMENT_AMPLIFIERS,821,966,1,412907,100%
2033,MLB-IP_TELEPHONES,61,69,1,412908,100%
2078,MLM-CAKE_SMOOTHERS,11,32,1,412909,100%
2110,MLM-TONER_REFILLS,29,20,1,412910,100%
2128,MLM-BASS_GUITAR_STRINGS,24,33,1,412911,100%
2141,MLM-CAR_ROOF_BOXES,19,43,1,412912,100%
2142,MLM-WINDSHIELD_WASHER_FLUID_RESERVOIRS,37,30,1,412913,100%
2143,MLM-SEAT_BELTS,27,38,1,412914,100%
2160,MLB-MOTORCYCLE_GASOLINE_TANK_CAPS,295,391,1,412915,100%
2168,MLM-COMPRESSION_SLEEVES,13,26,1,412916,100%
2220,MLB-MANGA,366,340,1,412917,100%
2223,MLB-JEWELRY_AND_WATCHES,475,556,1,412918,100%
2236,MLM-ROLLING_PINS,30,32,1,412919,100%
2257,MLM-FOOD_CONES,11,13,1,412920,100%
2288,MLM-LABEL_PRINTERS,9,12,1,412921,100%
2292,MLM-COIL_BINDING_MACHINES,31,24,1,412922,100%
2311,MLM-PET_PLAYPENS,15,32,1,412923,100%
2320,MLM-DOG_BARK_CONTROL_COLLARS,19,26,1,412924,100%
2322,MLM-FLOOR_MAKER_MOLDS,23,49,1,412925,100%
2340,MLB-VODKAS,226,300,1,412926,100%
2383,MLM-BABY_STERILIZERS,35,63,1,412927,100%
2400,MLB-AUTOMOTIVE_THROTTLE_BODIES,297,375,1,412928,100%
2410,MLM-INCENSES,12,16,1,412929,100%
2423,MLM-MEN_SPORT_SWIMWEAR,42,85,1,412930,100%
2444,MLB-CIRCUIT_BREAKERS,649,1079,1,412931,100%
2451,MLB-PARTY_GLASSES,47,83,1,412932,100%
2465,MLM-FOOTBALL_SOCKS,66,65,1,412933,100%
2472,MLB-TOOL_CABINETS,99,184,1,412934,100%
2539,MLM-FETAL_DOPPLERS,5,12,1,412935,100%
2543,MLM-NAIL_FILES,14,14,1,412936,100%
2594,MLM-DRYING_RACKS,45,100,1,412937,100%
2598,MLM-SPEAKERS_STANDS,40,67,1,412938,100%
2609,MLM-TROPHIES,22,22,1,412939,100%
2660,MLB-COOKING_PLOW_DISCS,143,299,1,412940,100%
2689,MLM-SOLDERING_MACHINES,41,72,1,412941,100%
2702,MLB-AUTOMOTIVE_AUDIO_CAPACITORS,35,69,1,412942,100%
2703,MLM-PHOTOGRAPHIC_INSTANT_FILMS,15,23,1,412943,100%
2708,MLM-MANIFOLD_GAUGE_SETS,14,32,1,412944,100%
2720,MLM-WORKBENCHES,9,14,1,412945,100%
2752,MLM-VOLLEYBALL_NETS,7,9,1,412946,100%
2799,MLB-AUTOMOTIVE_MIRROR_COVERS,461,496,1,412947,100%
2809,MLM-NAIL_SAMPLES,7,8,1,412948,100%
2833,MLB-ENGINE_INTAKE_HOSES,753,876,1,412949,100%
2840,MLB-MULTIGAME_MACHINES,169,523,1,412950,100%
2851,MLM-IRRIGATION_DRIPPERS,13,44,1,412951,100%
2928,MLB-CAKE_TOPPERS,396,465,1,412952,100%
2939,MLM-CRUTCHES,15,14,1,412953,100%
2951,MLM-EARTHWORMS,10,10,1,412954,100%
2972,MLB-KITCHEN_BOWLS,285,346,1,412955,100%
2998,MLM-LCD_DISPLAYS,5,4,1,412956,100%
3008,MLM-BARBELL_PADS,17,32,1,412957,100%
3046,MLB-TABLE_DRILLS,86,131,1,412958,100%
3055,MLB-ANTIQUE_KNIVES,441,771,1,412959,100%
3063,MLB-STEEL_SCRAPERS,70,134,1,412960,100%
3071,MLB-SAUCES_AND_DRESSINGS,101,114,1,412961,100%
3127,MLM-STEAM_CLEANERS,21,36,1,412962,100%
3151,MLB-WORK_COVERALLS_AND_OVERALLS,54,85,1,412963,100%
3166,MLM-MOSQUITO_NETS,28,64,1,412964,100%
3202,MLB-TABLE_TENNIS_TABLES,59,185,1,412965,100%
3206,MLB-ACUPRESSURE_WRISTBANDS,60,123,1,412966,100%
3209,MLB-FURNITURE_KNOBS,218,226,1,412967,100%
3267,MLB-WEIGHT_PLATES,113,149,1,412968,100%
3286,MLM-MANUAL_HOISTS,13,16,1,412969,100%
3291,MLB-CAR_CUP_HOLDERS,130,160,1,412970,100%
3312,MLM-HAND_GRIPS,18,25,1,412971,100%
3375,MLB-MODEMS,252,319,1,412972,100%
3376,MLM-TOY_GUITARS,13,27,1,412973,100%
3420,MLB-HOME_APPLIANCE_CONTACTORS_AND_RELAYS,389,576,1,412974,100%
3425,MLM-COMPUTER_REMOTE_CONTROLS,9,14,1,412975,100%
3448,MLM-PAPER_CLIPS,8,9,1,412976,100%
3520,MLM-FOAM_ROLLERS,10,2,1,412977,100%
3524,MLM-BICYCLE_CHILD_SEATS,10,7,1,412978,100%
3560,MLB-AUTOMOTIVE_MUD_GUARDS,105,122,1,412979,100%
3637,MLB-3D_PRINTERS,106,105,1,412980,100%
3698,MLM-INGROWN_NAIL_FIXERS,2,2,1,412981,100%
3725,MLB-INSTRUMENT_BOWS,30,32,1,412982,100%
3755,MLB-ROTARY_TATTOO_MACHINES,199,304,1,412983,100%
3757,MLB-CAR_DISTRIBUTOR_CAPS,124,135,1,412984,100%
3780,MLB-CUTICLE_PUSHERS,187,345,1,412985,100%
3791,MLM-LIQUOR_FLASKS,12,20,1,412986,100%
3793,MLM-BABY_NASAL_ASPIRATORS,6,1,1,412987,100%
3874,MLM-BLU_RAY_PLAYERS,31,44,1,412988,100%
3913,MLB-EYEBROW_STENCILS,42,76,1,412989,100%
3934,MLB-OUTER_TIE_ROD_ENDS,334,338,1,412990,100%
4014,MLB-VEHICLE_BRAKE_PADS,1161,1276,1,412991,100%
4019,MLB-CHRISTMAS_DOLLS,150,193,1,412992,100%
4072,MLB-AUTOMOTIVE_ENGINE_COVERS,38,41,1,412993,100%
4077,MLB-CAR_GLOVE_BOX_DOORS,234,240,1,412994,100%
4121,MLM-MICROMETERS,20,23,1,412995,100%
4145,MLB-REFRIGERATOR_AND_FREEZER_BINS,71,101,1,412996,100%
4162,MLB-BLUSHES,132,188,1,412997,100%
4171,MLB-AUTOMOTIVE_COOLANT_RESERVOIRS,382,420,1,412998,100%
4238,MLB-HOOKAH_BASES,91,121,1,412999,100%
4279,MLB-POCKET_WATCHES,211,327,1,413000,100%
4305,MLB-FISH_TANK_PLANTS,197,288,1,413001,100%
4324,MLM-MODELISM_SERVO_MOTORS,18,40,1,413002,100%
4341,MLB-DIRECT_BOXES,61,96,1,413003,100%
4357,MLB-MOTORCYCLE_WHEEL_HUBS,105,129,1,413004,100%
4359,MLB-DENTAL_ULTRASONIC_SCALERS,16,38,1,413005,100%
4365,MLB-RODENT_TOYS,26,173,1,413006,100%
4366,MLB-TOY_SOLDIERS,110,163,1,413007,100%
4370,MLB-CABIN_FILTERS,240,242,1,413008,100%
4382,MLB-ENGINE_COOLING_FAN_MOTORS,80,81,1,413009,100%
4401,MLB-NAUTICAL_ACCESSORIES,463,626,1,413010,100%
4403,MLB-MOTORCYCLE_IGNITION_COILS,78,91,1,413011,100%
4414,MLB-DOOR_AND_WINDOW_WEATHERSTRIPS,65,159,1,413012,100%
4460,MLB-MATE_SETS,205,323,1,413013,100%
4473,MLB-NETBOOKS,205,518,1,413014,100%
4474,MLB-SCHOOL_UNIFORMS,76,98,1,413015,100%
4518,MLB-PAINT_BRUSHES,67,72,1,413016,100%
4522,MLB-HORSE_SPURS,80,77,1,413017,100%
4545,MLB-TABLET_BATTERIES,96,106,1,413018,100%
4564,MLB-TEQUILAS,61,95,1,413019,100%
4572,MLM-GERMINATION_TRAYS,14,33,1,413020,100%
4629,MLB-LASER_KEYBOARDS,42,73,1,413021,100%
4676,MLB-TATTOO_INKS,95,151,1,413022,100%
4681,MLB-ELECTROLYTIC_CAPACITORS,321,423,1,413023,100%
4694,MLB-WASHING_MACHINE_AGITATORS,110,150,1,413024,100%
4701,MLM-FOOTWEAR_LASTS,14,14,1,413025,100%
4727,MLB-MOTORCYCLE_STARTER_MOTORS,120,168,1,413026,100%
4735,MLB-REFRIGERATOR_AND_FREEZER_THERMOSTATS,107,172,1,413027,100%
4752,MLB-PENCIL_SHARPENERS,13,17,1,413028,100%
4798,MLB-CROSSBOWS,128,220,1,413029,100%
4828,MLB-AUTOMOTIVE_MANUAL_TRANSMISSION_SHIFT_CABLES,213,231,1,413030,100%
4843,MLM-VIOLIN_AND_VIOLA_SHOULDER_RESTS,6,1,1,413031,100%
4857,MLB-NAUTICAL_WATER_PUMP_IMPELLERS,111,117,1,413032,100%
4859,MLM-TURBAN_TOWELS,6,6,1,413033,100%
4878,MLB-AUTOMOTIVE_PAINTS,63,95,1,413034,100%
4902,MLB-LOCKING_PLIERS,47,64,1,413035,100%
5001,MLB-MOTORCYCLE_GRAB_BARS,235,357,1,413036,100%
5010,MLM-BILLIARD_CHALKS,1,2,1,413037,100%
5017,MLB-AUTOMOTIVE_WHEEL_NUT_COVERS,63,63,1,413038,100%
5046,MLB-PACKAGING_TAPE_DISPENSERS,18,17,1,413039,100%
5049,MLB-CORKSCREWS,69,99,1,413040,100%
5053,MLB-DESKTOP_COMPUTER_EXPANSION_CARDS,136,214,1,413041,100%
5081,MLB-PEANUTS,50,88,1,413042,100%
5113,MLB-REFRIGERATOR_AND_FREEZER_SENSORS,83,102,1,413043,100%
5116,MLB-BASEBALL_AND_SOFTBALL_JERSEYS,45,84,1,413044,100%
5117,MLB-PLASTIC_WRAPS,45,53,1,413045,100%
5134,MLB-MODEL_RAILROADING_LOCOMOTIVES,62,67,1,413046,100%
5148,MLM-NAIL_GLUES,6,11,1,413047,100%
5170,MLB-AIR_CURTAINS,33,60,1,413048,100%
5205,MLB-WASHING_AND_DRYER_MACHINE_DOORS_AND_LIDS,130,151,1,413049,100%
5208,MLB-COLLECTIBLE_POSTAGE_STAMPS,101,148,1,413050,100%
5257,MLB-FABRIC_SOFTENERS,87,127,1,413051,100%
5273,MLB-PAINTS_AND_ACCESSORIES,141,226,1,413052,100%
5350,MLB-AUTOMOTIVE_SHOCK_ABSORBERS_AIR_BAGS,56,79,1,413053,100%
5371,MLB-CANDLE_HOLDERS,88,128,1,413054,100%
5401,MLB-BASS_GUITAR_STRINGS,68,86,1,413055,100%
5430,MLB-PET_COSTUMES,76,88,1,413056,100%
5472,MLB-DIVING_MASKS,78,124,1,413057,100%
5508,MLB-ANTIQUE_TOY_TRUCKS,58,124,1,413058,100%
5517,MLB-AUTOMOTIVE_EQUALIZERS,84,143,1,413059,100%
5535,MLB-MILK,62,74,1,413060,100%
5541,MLB-MOTORCYCLE_BRAKE_CALIPERS,153,186,1,413061,100%
5544,MLB-PET_DRESSES,69,96,1,413062,100%
5562,MLM-BABY_SHOWER_VISORS,6,25,1,413063,100%
5567,MLB-CUTTING_PLIERS,75,118,1,413064,100%
5572,MLB-CATALOGS,134,210,1,413065,100%
5591,MLB-SKATEBOARD_WHEELS,94,119,1,413066,100%
5593,MLB-MOTORCYCLE_KICK_LEVER_PEDALS,47,102,1,413067,100%
5599,MLB-SPICES,95,149,1,413068,100%
5689,MLB-SHOWER_AND_TOILET_CHAIRS,64,96,1,413069,100%
5700,MLB-AUTOMOTIVE_WHEEL_SPACERS,56,55,1,413070,100%
5706,MLB-SEWING_THREADS,129,202,1,413071,100%
5710,MLM-CORKSCREWS,17,26,1,413072,100%
5731,MLB-HORSE_PADS,64,97,1,413073,100%
5753,MLB-REFRIGERATOR_WATER_FILTERS,24,23,1,413074,100%
5767,MLB-BEER_KEGS,35,59,1,413075,100%
5778,MLB-PET_STAIRS_AND_RAMPS,83,113,1,413076,100%
5797,MLB-DOOR_AND_WINDOW_LATCHES,59,74,1,413077,100%
5801,MLB-WASHING_MACHINE_TIMERS,46,30,1,413078,100%
5806,MLB-TATTOO_INK_CAPS,18,43,1,413079,100%
5807,MLB-COIN_PURSES,35,32,1,413080,100%
5868,MLB-POOL_PUMP_AND_FILTER_KITS,99,203,1,413081,100%
5873,MLB-BICYCLE_EXTRACTOR_TOOLS,15,26,1,413082,100%
5891,MLM-STRING_TRIMMER_HEADS,4,4,1,413083,100%
5902,MLB-HEEL_CUPS,68,88,1,413084,100%
5964,MLB-ARCHERY_ARROWS,53,51,1,413085,100%
5973,MLM-WHIPPED_CREAM_DISPENSERS,2,1,1,413086,100%
6023,MLB-DIGITAL_WEATHER_STATIONS,13,30,1,413087,100%
6030,MLM-GARDEN_MACHINE_CARBURETORS,4,13,1,413088,100%
6051,MLB-LINEMAN_PLIERS,120,404,1,413089,100%
6068,MLB-NAUTICAL_COVERS,41,47,1,413090,100%
6100,MLB-ELECTRIC_CHARCOAL_AND_FIREWOOD_LIGHTERS,35,58,1,413091,100%
6115,MLB-TOY_ICE_CREAM_MACHINES,44,68,1,413092,100%
6116,MLB-AUTOMOTIVE_HEADRESTS,71,74,1,413093,100%
6117,MLB-COOKING_CREAMS,19,45,1,413094,100%
6121,MLB-BAKING_MATS,19,37,1,413095,100%
6149,MLB-SALAD_SPINNERS,29,40,1,413096,100%
6161,MLB-POKER_SETS,62,122,1,413097,100%
6183,MLB-TWEEZERS,132,211,1,413098,100%
6207,MLB-ELECTRIC_MASSAGES_SEATS,42,93,1,413099,100%
6216,MLB-TUBE_BENDERS,47,68,1,413100,100%
6243,MLB-MOTORCYCLE_KNEE_PADS,70,86,1,413101,100%
6245,MLB-ENGINE_VALVE_COVER_GASKET_SETS,186,196,1,413102,100%
6250,MLB-COMPRESSED_AIR_DUSTERS,11,26,1,413103,100%
6254,MLB-REFEREE_CARDS,21,52,1,413104,100%
6278,MLB-MOUTH_GUARDS,67,120,1,413105,100%
6282,MLB-WATERING_TIMERS,23,34,1,413106,100%
6291,MLB-BASEBALL_AND_SOFTBALL_BALLS,21,34,1,413107,100%
6315,MLB-SUITCASE_COVERS,16,27,1,413108,100%
6316,MLB-MECHANICAL_TALLY_COUNTERS,15,24,1,413109,100%
6329,MLB-TPMS_SENSORS,29,52,1,413110,100%
6356,MLM-DIGITAL_PORTABLE_MEDIA_PLAYER_BATTERIES,3,6,1,413111,100%
6359,MLB-WATER_FLOW_SENSORS,43,73,1,413112,100%
6365,MLB-CAR_BODY_SCOOPS,45,62,1,413113,100%
6385,MLB-ARCADE_PARTS_KITS,41,96,1,413114,100%
6458,MLB-RICE,29,43,1,413115,100%
6476,MLB-LAPTOP_HINGES,43,33,1,413116,100%
6521,MLM-FABRIC_CUTTING_MACHINES,2,1,1,413117,100%
6543,MLB-TACTICAL_BOARDS,25,30,1,413118,100%
6549,MLB-MAP_SENSORS,125,133,1,413119,100%
6553,MLB-FACIAL_TISSUES,8,12,1,413120,100%
6604,MLB-CIGARETTE_ROLLING_MACHINES,19,19,1,413121,100%
6653,MLB-GARMENT_COVERS,29,33,1,413122,100%
6654,MLB-PAPER_CLIPS,17,20,1,413123,100%
6657,MLB-TABLE_TENNIS_SETS,17,21,1,413124,100%
6664,MLB-MANUAL_BROCHETTE_MAKERS,31,67,1,413125,100%
6688,MLB-CAKE_LEVELERS,42,74,1,413126,100%
6702,MLB-GAME_CONSOLE_SCREEN_PROTECTORS,19,12,1,413127,100%
6707,MLB-MODEL_NAVAL_MOTOR_BOATS,37,81,1,413128,100%
6756,MLB-TRUNK_OPEN_CABLES,27,34,1,413129,100%
6760,MLM-MICROBLADING_RINGS,1,1,1,413130,100%
6787,MLB-GATE_GEAR_RACKS,73,85,1,413131,100%
6799,MLB-PRINTER_SPARE_TRAYS,17,11,1,413132,100%
6800,MLM-EYE_CARE_MEDICINES,2,3,1,413133,100%
6809,MLB-BINDING_SPINES,59,136,1,413134,100%
6812,MLB-BICYCLE_MULTIFUNCTION_TOOLS,14,19,1,413135,100%
6846,MLB-AUTOMOTIVE_LIFTS,65,109,1,413136,100%
6922,MLB-PHOTOGRAPHIC_FILM_ROLLS,4,3,1,413137,100%
6923,MLB-MANICURE_AND_PEDICURE_FINGER_SEPARATORS,9,15,1,413138,100%
6931,MLB-CUTTING_PLOTTER_BLADES,15,30,1,413139,100%
6968,MLB-HUMIDORS,18,34,1,413140,100%
6988,MLB-ELECTRIC_POOL_IONIZERS,25,63,1,413141,100%
6990,MLB-SEWING_NEEDLES,21,17,1,413142,100%
6999,MLB-TOY_VANITIES,39,105,1,413143,100%
7050,MLB-STRAPPING_MACHINES_AND_TENSIONERS,10,16,1,413144,100%
7060,MLB-REUSABLE_ICE_CUBES,21,37,1,413145,100%
7107,MLB-GINGERBREADS,8,6,1,413146,100%
7136,MLB-CHESS_CLOCKS,38,66,1,413147,100%
7149,MLB-POE_INJECTORS,44,87,1,413148,100%
7150,MLB-CLAPPERBOARDS,9,14,1,413149,100%
7158,MLB-SURGICAL_MASKS,43,143,1,413150,100%
7181,MLB-ANTI_STATIC_WRIST_STRAPS,10,12,1,413151,100%
7192,MLB-SOCK_AIDS,10,9,1,413152,100%
7336,MLB-KITCHEN_CORN_STRIPPERS,9,19,1,413153,100%
7376,MLB-TURBAN_TOWELS,10,27,1,413154,100%
7483,MLB-BABY_BATHTUB_SEATS,4,2,1,413155,100%
7511,MLB-C_CLAMPS,7,5,1,413156,100%
7518,MLB-HAND_DRYERS,12,18,1,413157,100%
7550,MLB-EROTIC_ANAL_AND_VAGINAL_DOUCHES,7,17,1,413158,100%
7561,MLB-SHOE_HORNS,2,1,1,413159,100%
7576,MLB-KITCHEN_BATTER_DISPENSERS,3,8,1,413160,100%
7619,MLB-PLANER_AND_JOINTER_KNIVES,11,32,1,413161,100%
7625,MLB-CORRECTION_TAPES_AND_FLUIDS,5,9,1,413162,100%
7642,MLB-DUROMETERS,5,3,1,413163,100%
0,MLM-INDIVIDUAL_HOUSES_FOR_SALE,723,631,0,413163,100%
3,MLM-GRAPHICS_CARDS,401,646,0,413163,100%
8,MLM-NAPKIN_HOLDERS,10,14,0,413163,100%
9,MLM-FLATS,199,251,0,413163,100%
11,MLM-HORSES_AND_MARES,67,78,0,413163,100%
12,MLM-CARS_AND_VANS,14165,16909,0,413163,100%
13,MLM-CONSTRUCTION_MATERIALS,186,232,0,413163,100%
20,MLM-ELECTRIC_BICYCLES,61,149,0,413163,100%
25,MLM-ANTI_THEFT_STUDS,152,160,0,413163,100%
41,MLM-MOTORCYCLES,2663,3373,0,413163,100%
53,MLM-FUEL_INJECTORS,86,103,0,413163,100%
55,MLM-CLOTHING_PATCHES,88,128,0,413163,100%
58,MLM-BASEBALL_AND_SOFTBALL_JERSEYS,124,184,0,413163,100%
60,MLM-KIDS_WRIST_LEASHES,5,13,0,413163,100%
61,MLM-HORSE_RANCH_ROPES,3,3,0,413163,100%
63,MLM-AUTOMOTIVE_STEREO_FRAME_ADAPTERS,259,348,0,413163,100%
66,MLM-DOLL_VEHICLES,18,18,0,413163,100%
67,MLM-CASH_REGISTERS,24,47,0,413163,100%
70,MLM-CLOTHING_LOTS,251,426,0,413163,100%
71,MLM-ENGINE_PISTONS,25,24,0,413163,100%
75,MLM-ENGINE_CONTROL_MODULES,123,160,0,413163,100%
76,MLM-HYDROPONIC_GROWING_SYSTEMS,18,22,0,413163,100%
79,MLM-LAPTOP_HOUSINGS,74,70,0,413163,100%
80,MLM-CAR_WHEELS,965,1246,0,413163,100%
82,MLM-FREEZERS,71,127,0,413163,100%
84,MLM-AUTOMOTIVE_POLY_V_BELTS,63,63,0,413163,100%
103,MLM-WASHING_MACHINE_ELECTROVALVES,11,22,0,413163,100%
106,MLM-CAR_CARBURETORS,72,83,0,413163,100%
110,MLM-WINDSHIELD_WIPER_MOTORS,47,41,0,413163,100%
116,MLM-REPTILE_AND_AMPHIBIAN_TERRARIUMS,24,38,0,413163,100%
118,MLM-PLANT_POTS_AND_PLANTERS,148,203,0,413163,100%
119,MLM-BATHTUBS,43,56,0,413163,100%
123,MLM-AIR_CONDITIONERS,178,274,0,413163,100%
126,MLM-ACCORDION_STRAPS,6,2,0,413163,100%
127,MLM-WRENCH_SETS,117,184,0,413163,100%
131,MLM-OVENS,52,91,0,413163,100%
137,MLM-MOTORCYCLE_LUGGAGE_RACKS,18,27,0,413163,100%
139,MLM-DOG_TOY_BONES,7,5,0,413163,100%
145,MLM-FISH_TANKS,97,138,0,413163,100%
154,MLM-VEHICLE_BRAKE_PADS,221,195,0,413163,100%
157,MLM-CRASHED_CARS,172,130,0,413163,100%
158,MLM-FUTONS,35,57,0,413163,100%
163,MLM-ARTIFICIAL_PLANTS,33,32,0,413163,100%
166,MLM-HERB_GRINDERS,57,81,0,413163,100%
167,MLM-CAKE_TOPPERS,42,57,0,413163,100%
171,MLM-SIM_CARD_TRAYS,69,140,0,413163,100%
174,MLM-MODEL_AIRCRAFT_HELICOPTERS,48,44,0,413163,100%
175,MLM-EROTIC_CLOTHING,51,50,0,413163,100%
177,MLM-PLANTS,332,426,0,413163,100%
180,MLM-MOTORCYCLE_BRAKE_MASTER_CYLINDERS,16,20,0,413163,100%
188,MLM-FISHING_RODS,56,71,0,413163,100%
195,MLM-PUREBRED_DOGS,1180,1682,0,413163,100%
204,MLM-CLASSIC_CARS,470,586,0,413163,100%
210,MLM-MINI_COMPONENT_SYSTEMS,107,189,0,413163,100%
211,MLM-MACHETES,34,95,0,413163,100%
214,MLM-PARTY_WIGS,19,30,0,413163,100%
216,MLM-LIVING_ROOM_SETS,105,182,0,413163,100%
229,MLM-DOG_MUZZLES,16,18,0,413163,100%
230,MLM-AUTOMOTIVE_TRUNK_CARGO_COVER_SHIELDS,3,4,0,413163,100%
235,MLM-APARTMENTS_FOR_RENT,354,376,0,413163,100%
236,MLM-SEX_DOLLS,137,280,0,413163,100%
237,MLM-CHAIR_COVERS,21,15,0,413163,100%
244,MLM-EMBEDDED_SWITCH_MODE_POWER_SUPPLIES,11,19,0,413163,100%
245,MLM-ENERGY_DRINKS,29,34,0,413163,100%
250,MLM-ELECTROLYTIC_CAPACITORS,11,6,0,413163,100%
252,MLM-BICYCLE_CASSETTES,16,11,0,413163,100%
253,MLM-POUFS,53,102,0,413163,100%
255,MLM-GUN_CLEANING_KITS,28,34,0,413163,100%
261,MLM-INDIVIDUAL_APARTMENTS_FOR_SALE,186,207,0,413163,100%
268,MLM-SQUEEZERS,3,7,0,413163,100%
269,MLM-VIDEO_GAME_GUITARS,31,31,0,413163,100%
279,MLM-MODEL_AIRCRAFT_PLANES,75,79,0,413163,100%
280,MLM-BEDDING_SETS,10,8,0,413163,100%
297,MLM-HOUSES_FOR_RENT,227,263,0,413163,100%
303,MLM-RETRO_EXCAVATORS,16,13,0,413163,100%
304,MLM-IRRIGATION_VALVES,16,17,0,413163,100%
308,MLM-BATHROOM_SUPPLIES,397,547,0,413163,100%
316,MLM-AUTOMOBILE_FUEL_PUMPS,146,164,0,413163,100%
323,MLM-DJ_TURNTABLES,31,16,0,413163,100%
324,MLM-LASER_CUTTING_AND_ENGRAVING_MACHINES,27,46,0,413163,100%
325,MLM-SCISSORS,17,13,0,413163,100%
332,MLM-EGR_VALVES,23,26,0,413163,100%
334,MLM-AIRGUN_PELLETS,139,262,0,413163,100%
341,MLM-SNAP_OFF_UTILITY_KNIVES,35,42,0,413163,100%
342,MLM-PAINTBALL_MARKERS,87,135,0,413163,100%
343,MLM-QUILTS_AND_COVERLETS,173,257,0,413163,100%
344,MLM-LENS_FILTERS,30,29,0,413163,100%
349,MLM-FOOTBALL_CAPS,173,217,0,413163,100%
350,MLM-CYCLING_JERSEYS,121,174,0,413163,100%
357,MLM-ORTHOPEDIC_ANKLE_BRACES,44,61,0,413163,100%
359,MLM-CLEANING_CLOTHS,51,61,0,413163,100%
365,MLM-ELECTRIC_LUNCHBOXES,5,5,0,413163,100%
368,MLM-GATE_MOTORS,47,56,0,413163,100%
380,MLM-ROOSTERS_AND_HENS,81,62,0,413163,100%
381,MLM-AUTOMOTIVE_NERF_BARS,172,237,0,413163,100%
384,MLM-CANDLE_HOLDERS,10,18,0,413163,100%
387,MLM-AUTOMOTIVE_OIL_PUMPS,62,72,0,413163,100%
389,MLM-TABLEWARE_SETS,81,127,0,413163,100%
391,MLM-DOLLHOUSE_FURNITURE_AND_APPLIANCES,12,14,0,413163,100%
403,MLM-JEWELRY_DISPLAYS,60,59,0,413163,100%
405,MLM-COLLECTIBLE_MILITARY_JACKETS,36,53,0,413163,100%
417,MLM-PRESSURE_GAUGES,39,53,0,413163,100%
423,MLM-SPORT_BRAS,51,67,0,413163,100%
428,MLM-ROTISSERIE_OVENS,17,18,0,413163,100%
429,MLM-STARTERS,119,140,0,413163,100%
430,MLM-KANGOO_JUMPS,7,10,0,413163,100%
433,MLM-EDUCATIONAL_SOFTWARE,18,30,0,413163,100%
434,MLM-SHAVING_CREAMS,8,2,0,413163,100%
437,MLM-HAIR_DYES_COLORANTS_DECOLORANTS,162,200,0,413163,100%
441,MLM-CAMPING_STOVES,55,33,0,413163,100%
442,MLM-CHRISTMAS_TREE_ORNAMENTS,205,284,0,413163,100%
446,MLM-STAIRS_AND_BALCONIES_RAILS,17,15,0,413163,100%
450,MLM-ABDOMINAL_TONING_BELTS,17,35,0,413163,100%
452,MLM-CEREAL_DISPENSERS,9,3,0,413163,100%
453,MLM-INDUSTRIAL_ICE_CREAM_MACHINES,46,82,0,413163,100%
455,MLM-SCULPTURES,66,55,0,413163,100%
460,MLM-ANIMALS_AND_PETS,55,92,0,413163,100%
463,MLM-WATER_RADIATORS,133,155,0,413163,100%
464,MLM-AUTOMOTIVE_ENGINE_VALVE_COVERS,28,30,0,413163,100%
469,MLM-AUTOMOTIVE_SHOCK_ABSORBERS,481,500,0,413163,100%
471,MLM-AUTOMOTIVE_CANISTER_PURGE_VALVES,7,4,0,413163,100%
473,MLM-CAT_TOYS,48,75,0,413163,100%
475,MLM-POWER_INVERTERS,65,71,0,413163,100%
476,MLM-COTTON_CANDY_MACHINES,21,66,0,413163,100%
477,MLM-GAME_CONSOLE_COOLERS,39,55,0,413163,100%
485,MLM-ALTERNATORS,62,54,0,413163,100%
486,MLM-SHELF_UNITS,41,79,0,413163,100%
487,MLM-BOX_SPRING_BASES,155,279,0,413163,100%
494,MLM-AUTOMOTIVE_CRASH_GUARDS,95,103,0,413163,100%
497,MLM-VIDEO_GAME_CONTROLLER_COVERS,51,94,0,413163,100%
500,MLM-CELLPHONE_BATTERY_CASES,68,114,0,413163,100%
501,MLM-WASHING_MACHINE_GEARBOXES,17,16,0,413163,100%
502,MLM-MANUAL_LAWN_MOWERS,30,37,0,413163,100%
504,MLM-INDIVIDUAL_LANDS_FOR_SALE,133,159,0,413163,100%
506,MLM-AUTOMOTIVE_SKIRTS,242,282,0,413163,100%
507,MLM-CANNED_AND_PRESERVED_FOOD,41,44,0,413163,100%
513,MLM-AUTOMOTIVE_TIMING_BELT_TENSIONER_PULLEYS,21,21,0,413163,100%
514,MLM-STRING_INSTRUMENT_BRIDGES,11,7,0,413163,100%
517,MLM-TACTICAL_SLINGS,43,67,0,413163,100%
520,MLM-MASSAGE_STONES,3,5,0,413163,100%
521,MLM-AUTOMOTIVE_PAINTS,28,42,0,413163,100%
523,MLM-BABY_MOBILES,36,75,0,413163,100%
525,MLM-SALON_FURNITURE,68,124,0,413163,100%
528,MLM-SPORT_AND_BAZAAR_BOTTLES,66,114,0,413163,100%
529,MLM-TABLECLOTHS,40,49,0,413163,100%
531,MLM-BOOKMARKS,24,34,0,413163,100%
532,MLM-AUTOMOTIVE_CLUTCH_KITS,112,130,0,413163,100%
534,MLM-BEDS,323,465,0,413163,100%
535,MLM-ULTRABOOKS,11,11,0,413163,100%
540,MLM-AUTOMOTIVE_ENGINE_FANS,70,81,0,413163,100%
541,MLM-WRENCHES,100,112,0,413163,100%
542,MLM-FIRST_AID_KITS,17,23,0,413163,100%
544,MLM-CLIMBING_HOLDS,4,1,0,413163,100%
546,MLM-RODENT_DRINKERS_AND_FEEDERS,9,11,0,413163,100%
549,MLM-OPTICAL_INSTRUMENTS,4,7,0,413163,100%
551,MLM-CNC_ROUTERS,24,44,0,413163,100%
555,MLM-SODIUM_BICARBONATE,9,3,0,413163,100%
566,MLM-AUTOMOTIVE_ENGINES,111,158,0,413163,100%
567,MLM-SHIN_GUARDS,65,101,0,413163,100%
568,MLM-DOG_AND_CAT_SHAMPOOS_AND_CONDITIONERS,22,17,0,413163,100%
569,MLM-COGNACS,10,23,0,413163,100%
572,MLM-MILK,13,10,0,413163,100%
575,MLM-SEX_TOYS_AND_SUPPLIES,105,129,0,413163,100%
579,MLM-ARTISTIC_ACRYLIC_PAINTS,56,104,0,413163,100%
581,MLM-CAR_AC_DASHBOARD_VENTS,40,66,0,413163,100%
587,MLM-AUTOMOTIVE_WATER_PUMPS,101,94,0,413163,100%
588,MLM-AUTOMOTIVE_ENGINE_MOUNTS,118,117,0,413163,100%
591,MLM-FABRICS,55,61,0,413163,100%
593,MLM-PASTRY_BRUSHES,6,11,0,413163,100%
594,MLM-HUNTING_NETS,22,19,0,413163,100%
596,MLM-DOLLHOUSES,77,75,0,413163,100%
601,MLM-BICYCLE_GROUPSETS,24,27,0,413163,100%
602,MLM-GUN_GRIPS,13,17,0,413163,100%
604,MLM-BASEBALL_AND_SOFTBALL_BATS,151,207,0,413163,100%
607,MLM-DOORS,71,90,0,413163,100%
611,MLM-SAFETY_HELMETS,58,94,0,413163,100%
614,MLM-BUSES,90,106,0,413163,100%
616,MLM-DISPLAY_STRIPS,4,11,0,413163,100%
618,MLM-AUTOMOTIVE_TURBOCHARGERS,49,49,0,413163,100%
621,MLM-FISHING_SPEARGUNS,9,18,0,413163,100%
627,MLM-BLUSHES,29,27,0,413163,100%
628,MLM-HORSE_SPURS,34,47,0,413163,100%
629,MLM-INFLATABLE_BOUNCE_HOUSES,101,190,0,413163,100%
630,MLM-WOMEN_SPORT_SWIMWEAR,46,55,0,413163,100%
633,MLM-MERCHANDISER_REFRIGERATORS,118,176,0,413163,100%
634,MLM-CARDS_AND_INVITATIONS,203,244,0,413163,100%
635,MLM-HEADPIECES_TIARAS_AND_HEADBANDS,195,245,0,413163,100%
636,MLM-AUTOMOTIVE_IGNITION_KEYS,101,94,0,413163,100%
637,,851,1208,0,413163,100%
638,MLM-AIRBAGS,57,48,0,413163,100%
639,MLM-MANUAL_AIR_PUMPS,61,99,0,413163,100%
640,MLM-MOTORCYCLE_CHEST_PROTECTORS,37,61,0,413163,100%
647,MLM-HAIR_ROLLERS,4,9,0,413163,100%
651,MLM-HANDICRAFT_BOXES,161,196,0,413163,100%
652,MLM-ANTIQUE_KNIVES,70,85,0,413163,100%
654,MLM-ELECTRIC_SAWS,43,68,0,413163,100%
655,MLM-BASS_GUITARS,160,140,0,413163,100%
656,MLM-AUTOMOTIVE_DASHBOARDS,92,84,0,413163,100%
657,MLM-BRIEFCASES,120,219,0,413163,100%
658,MLM-ACUPUNCTURE_NEEDLES,14,12,0,413163,100%
661,MLM-SWAY_BAR_LINKS,69,78,0,413163,100%
664,MLM-DIGITAL_CENTRIFUGE_MACHINES,11,12,0,413163,100%
666,MLM-PEDALBOARDS,27,46,0,413163,100%
667,MLM-RACKS_AND_PINIONS,127,110,0,413163,100%
668,MLM-AUTOMOTIVE_AC_COMPRESSORS,81,53,0,413163,100%
669,MLM-BUMPER_IMPACT_ABSORBERS,61,51,0,413163,100%
676,MLM-ENGINE_CRANKSHAFT_PULLEYS,22,17,0,413163,100%
681,MLM-STORAGE_DRAWERS,142,204,0,413163,100%
683,MLM-CAMERA_BATTERIES,47,52,0,413163,100%
689,MLM-BIRD_TOYS,26,29,0,413163,100%
691,MLM-CAR_GLOVE_BOX_DOORS,28,28,0,413163,100%
692,MLM-PRINTER_MOTHERBOARDS,14,24,0,413163,100%
693,MLM-SWAY_BARS,29,19,0,413163,100%
698,MLM-FUEL_LEVEL_FLOATS,60,40,0,413163,100%
703,MLM-BABY_PACIFIERS,63,90,0,413163,100%
704,MLM-GARDEN_CHAIRS,81,160,0,413163,100%
706,MLM-BOOKS_MAGAZINES_AND_COMICS,70,88,0,413163,100%
710,MLM-CAR_SCREENS,81,120,0,413163,100%
713,MLM-HORSE_SADDLES,51,36,0,413163,100%
714,MLM-SCREWS,104,143,0,413163,100%
715,MLM-VINYL_FLOORINGS,62,99,0,413163,100%
716,MLM-DOOR_AND_WINDOW_LOCKS,112,114,0,413163,100%
718,MLM-VEHICLE_FUEL_FILTERS,33,28,0,413163,100%
719,MLM-UNIVERSAL_CAR_REMOTES,22,32,0,413163,100%
720,MLM-BICYCLE_DISC_BRAKE_CALIPERS,11,26,0,413163,100%
721,MLM-POCKET_WATCHES,46,49,0,413163,100%
723,MLM-SAFETY_GLOVES,94,125,0,413163,100%
724,MLM-NETBOOKS,16,8,0,413163,100%
727,MLM-HEADBOARDS,59,79,0,413163,100%
737,MLM-EROTIC_BALLS,14,17,0,413163,100%
740,MLM-HUMAN_SKELETON_ANATOMICAL_MODELS,8,5,0,413163,100%
741,MLM-SOLAR_PANELS,121,257,0,413163,100%
742,MLM-KATANA_SWORDS,124,251,0,413163,100%
744,MLM-BICYCLE_FRONT_DERAILLEURS,22,28,0,413163,100%
746,MLM-BICYCLE_HANDLEBAR_GRIPS,19,31,0,413163,100%
747,MLM-WETSUITS,36,52,0,413163,100%
749,MLM-ELECTRIC_JUGS,20,26,0,413163,100%
750,MLM-TOILETS,38,59,0,413163,100%
751,MLM-NEGATOSCOPES,10,4,0,413163,100%
752,MLM-HAIR_REMOVAL_SPRINGS,2,3,0,413163,100%
753,MLM-TOY_CASH_REGISTERS,16,12,0,413163,100%
755,MLM-BABIES_FORMULA,43,52,0,413163,100%
756,MLM-MOTORCYCLE_SADDLEBAGS,96,138,0,413163,100%
757,MLM-DIFFERENTIALS,13,16,0,413163,100%
759,MLM-BUCKETS_AND_BASINS,19,23,0,413163,100%
764,MLM-KARTS,2,5,0,413163,100%
765,MLM-DRINK_PITCHERS,34,36,0,413163,100%
770,MLM-DISTRIBUTION_KITS,124,124,0,413163,100%
771,MLM-DRAFTING_KITS,6,13,0,413163,100%
775,MLM-HABERDASHERY_RIBBONS,31,29,0,413163,100%
776,MLM-CD_AND_DVD_PLAYERS,52,55,0,413163,100%
777,MLM-ELECTRIC_UNICYCLES,2,2,0,413163,100%
779,MLM-LIQUORS,26,42,0,413163,100%
781,MLM-CHRISTMAS_WREATHS,37,36,0,413163,100%
785,MLM-MOTORCYCLE_MUFFLERS,105,180,0,413163,100%
786,MLM-CURTAIN_RODS,64,64,0,413163,100%
789,MLM-CLARINETS,7,3,0,413163,100%
790,MLM-TV_SERIES,85,131,0,413163,100%
792,MLM-SHOCK_MOUNT_INSOLATORS,105,117,0,413163,100%
793,MLM-MEASURING_SPOONS,23,55,0,413163,100%
804,MLM-SCREEN_PRINTING_INKS,22,39,0,413163,100%
805,MLM-AIR_CONDITIONER_CONTROL_BOARDS,23,26,0,413163,100%
806,MLM-AUTOMOTIVE_DASHBOARD_COVERS,104,155,0,413163,100%
809,MLM-AUTOMOTIVE_SPRING_SUSPENSIONS,51,74,0,413163,100%
811,MLM-WEDDING_BANDS,74,118,0,413163,100%
812,MLM-STEERING_COLUMNS,29,10,0,413163,100%
815,MLM-BICYCLE_V_BRAKE_CALIPERS,3,3,0,413163,100%
816,MLM-CHAFING_DISHES,26,41,0,413163,100%
820,MLM-WALKIE_TALKIE_BATTERIES,1,1,0,413163,100%
822,MLM-VEHICLE_SCRATCH_REMOVERS,14,22,0,413163,100%
825,MLM-BED_AND_CRIB_SAFETY_RAILS,13,42,0,413163,100%
830,MLM-DRILL_ADAPTERS,48,76,0,413163,100%
831,MLM-RUM,27,30,0,413163,100%
832,MLM-KEY_DUPLICATING_MACHINES,11,23,0,413163,100%
833,MLM-AUTOMOTIVE_BRIGHTENERS,73,119,0,413163,100%
834,MLM-TANK_STANDS,20,19,0,413163,100%
835,MLM-BONGS,114,187,0,413163,100%
836,MLM-GAS_CYLINDERS,43,53,0,413163,100%
837,MLM-RESISTORS,42,69,0,413163,100%
838,MLM-VEILS,11,20,0,413163,100%
839,MLM-AUTOMOTIVE_STEERING_WHEELS,163,199,0,413163,100%
840,MLM-HARMONICAS,22,26,0,413163,100%
842,MLM-RECEPTION_DESKS,23,23,0,413163,100%
845,MLM-FENCE_CHARGERS,4,7,0,413163,100%
846,MLM-DINING_SETS,258,333,0,413163,100%
847,MLM-LASER_PRINTER_DRUMS,39,58,0,413163,100%
849,MLM-FILE_BOXES,11,57,0,413163,100%
851,MLM-GUN_AMMUNITION_MAGAZINES,39,77,0,413163,100%
852,MLM-BABY_CRIBS_AND_BASSINETS,25,30,0,413163,100%
854,MLM-CONSTRUCTION_FINISHING_TROWELS,11,21,0,413163,100%
858,MLM-OTHER_VEHICLES,74,87,0,413163,100%
860,MLM-COLANDERS,18,25,0,413163,100%
861,MLM-EROTIC_LINGERIE_SETS,2,0,0,413163,100%
862,MLM-BOOKCASES,98,186,0,413163,100%
866,MLM-POWERED_RIDE_ON_TOYS,212,350,0,413163,100%
872,MLM-ROLLING_SHOPPING_CARTS,36,48,0,413163,100%
879,MLM-INSTANT_COFFEE,38,61,0,413163,100%
880,MLM-WIRE_STRIPPERS,19,13,0,413163,100%
885,MLM-GARDEN_STONES,20,22,0,413163,100%
886,MLM-TRACTORS,31,45,0,413163,100%
887,MLM-ROOF_PANELS,113,131,0,413163,100%
889,MLM-READY_TO_DRINK_COCKTAILS,24,52,0,413163,100%
896,MLM-TOY_VEHICLE_BATTERY_CHARGERS,6,9,0,413163,100%
897,MLM-TABLE_CLOCKS,38,28,0,413163,100%
899,MLM-AUTOMOTIVE_SIDE_VIEW_MIRROR_GLASSES,30,20,0,413163,100%
900,MLM-SUTURE_THREADS,12,10,0,413163,100%
902,MLM-AUTOMOTIVE_EQUALIZERS,44,42,0,413163,100%
907,MLM-PENIS_RINGS,62,98,0,413163,100%
910,MLM-BOOMBOXES,17,12,0,413163,100%
911,MLM-DIGITAL_TEMPERATURE_CONTROLLERS,15,13,0,413163,100%
912,MLM-AUTOMOTIVE_FOG_LIGHT_GRILLS,104,141,0,413163,100%
916,MLM-FOOD_PROCESSORS,45,82,0,413163,100%
918,MLM-FOOTBALL_JACKETS,93,145,0,413163,100%
919,MLM-POLYCARBONATE_SHEETS,22,34,0,413163,100%
922,MLM-ROOMS_FOR_RENT,24,28,0,413163,100%
923,MLM-PLIER_SETS,6,6,0,413163,100%
925,MLM-INFLATABLE_POOLS,51,66,0,413163,100%
926,MLM-SEWING_THREADS,41,47,0,413163,100%
930,MLM-HOSPITAL_BEDS,35,60,0,413163,100%
931,MLM-CRIB_BEDDING_SETS,12,12,0,413163,100%
933,MLM-AUTOMOBILE_FENDER_LINERS,82,123,0,413163,100%
934,MLM-CELLPHONE_REPLACEMENT_CAMERAS,19,9,0,413163,100%
935,MLM-PET_COSTUMES,141,254,0,413163,100%
936,MLM-DECORATIVE_PERFUME_BOTTLES,10,8,0,413163,100%
937,MLM-TRANSISTORS,55,59,0,413163,100%
938,MLM-RACQUETS,43,59,0,413163,100%
941,MLM-AUTOMOTIVE_IGNITION_COILS,122,113,0,413163,100%
943,MLM-LIQUID_HAND_AND_BODY_SOAPS,20,30,0,413163,100%
944,MLM-SPARK_PLUGS,158,172,0,413163,100%
949,MLM-TOOL_MILLS,29,21,0,413163,100%
951,MLM-AUTOMOTIVE_FRONT_BUMPERS,215,234,0,413163,100%
954,MLM-PAIN_RELIEF_MEDICINES,9,12,0,413163,100%
955,MLM-COFFEE_TABLES,45,58,0,413163,100%
957,MLM-AIRBRUSHES,43,51,0,413163,100%
958,MLM-TIRE_INNER_TUBES,25,36,0,413163,100%
959,MLM-COFFEE_CREAMERS,9,11,0,413163,100%
961,MLM-INDUSTRIAL_PULLEYS,28,27,0,413163,100%
965,MLM-GROUND_AND_WHOLE_BEANS_COFFEE,47,65,0,413163,100%
967,MLM-STIMULATING_PILLS_AND_CAPSULES,24,37,0,413163,100%
968,MLM-BEDDING,29,33,0,413163,100%
978,MLM-BOOMERANGS,2,2,0,413163,100%
980,MLM-KITCHEN_SHOVELS_AND_SPATULAS,31,63,0,413163,100%
983,MLM-GARDEN_BENCHES,30,27,0,413163,100%
984,MLM-AUTOMOTIVE_PARKING_BRAKE_LEVER_BOOTS,11,9,0,413163,100%
985,MLM-CATS,137,186,0,413163,100%
986,MLM-ANGLE_CLAMPS,9,20,0,413163,100%
987,MLM-HAMMOCKS,71,96,0,413163,100%
989,MLM-ENGINE_VALVE_COVER_GASKET_SETS,41,43,0,413163,100%
990,MLM-CAR_HOODS,41,29,0,413163,100%
993,MLM-AUTOMOTIVE_SHOCK_ABSORBER_KITS,67,98,0,413163,100%
995,MLM-VEHICLE_SHAMPOOS,17,19,0,413163,100%
997,MLM-ELECTRICAL_OUTLETS,65,65,0,413163,100%
998,MLM-WINDSHIELD_WIPERS,141,181,0,413163,100%
999,MLM-CAR_FRONT_MASKS,147,146,0,413163,100%
1000,MLM-MARTIAL_ARTS_UNIFORMS,85,147,0,413163,100%
1002,MLM-FOOTBALL_EQUIPMENT_AND_ACCESSORIES,51,61,0,413163,100%
1003,MLM-AUTOMOTIVE_COMPRESSION_DRIVERS,15,30,0,413163,100%
1004,MLM-CERAMIC_BIDETS,13,35,0,413163,100%
1005,MLM-COMBS,32,39,0,413163,100%
1006,MLM-ELECTRIC_DEMOLITION_HAMMERS,48,72,0,413163,100%
1009,MLM-MOTORCYCLE_GASOLINE_TANKS,23,25,0,413163,100%
1012,MLM-HOUSEHOLD_CLEANING_WAXES,3,4,0,413163,100%
1013,MLM-SCHOOL_UNIFORMS,22,29,0,413163,100%
1016,MLM-DISHES_PLATES,76,81,0,413163,100%
1018,MLM-AIR_PURIFIERS,21,24,0,413163,100%
1020,MLM-POPCORN,6,6,0,413163,100%
1021,MLM-COLLECTIBLE_BILLS,73,81,0,413163,100%
1024,MLM-DRUMSTICKS_MALLETS_AND_BRUSHES,52,61,0,413163,100%
1025,MLM-AIRTIGHT_BAGS,12,13,0,413163,100%
1026,MLM-FORKLIFTS,29,33,0,413163,100%
1027,MLM-PEPPER_SPRAYS,34,43,0,413163,100%
1028,MLM-CAMPING_COTS,28,58,0,413163,100%
1029,MLM-FISHING_TACKLE_BOXES,12,8,0,413163,100%
1031,MLM-MOTORCYCLE_ALTERNATOR_STATORS,11,10,0,413163,100%
1034,MLM-PREAMPLIFIERS,12,19,0,413163,100%
1037,MLM-SIM_CARD_ADAPTERS,22,53,0,413163,100%
1038,MLM-HUMIDORS,53,80,0,413163,100%
1039,MLM-LADLES,14,36,0,413163,100%
1040,MLM-AUTOMOTIVE_SUN_SHADES,79,202,0,413163,100%
1042,MLM-DRAIN_GRATES,19,17,0,413163,100%
1043,MLM-MOTORCYCLE_LEVERS,37,43,0,413163,100%
1044,MLM-MANICURE_TABLES,58,90,0,413163,100%
1046,MLM-DISPOSABLE_PARTY_KITS,65,98,0,413163,100%
1047,MLM-PET_DRESSES,58,81,0,413163,100%
1048,MLM-AUTOMOTIVE_EXHAUST_TIPS,37,47,0,413163,100%
1050,MLM-STEP_PLATFORMS,20,28,0,413163,100%
1051,MLM-TABLET_STANDS_AND_MOUNTS,26,48,0,413163,100%
1052,MLM-SELF_ADHESIVE_LABELS,65,78,0,413163,100%
1053,MLM-WHEELS_BEARINGS,96,110,0,413163,100%
1058,MLM-HAIR_TIES,27,57,0,413163,100%
1060,MLM-BEDROOM_SETS,64,103,0,413163,100%
1061,MLM-STORAGE_DRUMS,20,14,0,413163,100%
1062,MLM-E_READERS,29,38,0,413163,100%
1063,MLM-DECORATIVE_TILES_AND_MOSAICS,16,22,0,413163,100%
1068,MLM-MOTORCYCLE_SHOCK_ABSORBERS,42,51,0,413163,100%
1070,MLM-CYMBALS,65,69,0,413163,100%
1071,MLM-KERCHIEFS_AND_PASHMINAS,63,100,0,413163,100%
1075,MLM-BATHROOM_SINKS,87,153,0,413163,100%
1076,MLM-NAIL_DUST_COLLECTORS,8,20,0,413163,100%
1080,MLM-STRING_TRIMMERS,7,14,0,413163,100%
1082,MLM-AUTOMOTIVE_ENGINE_COOLANT_THERMOSTAT_HOUSINGS,6,8,0,413163,100%
1083,MLM-AUTOMOTIVE_SEATS,55,80,0,413163,100%
1084,MLM-INCENSE_HOLDERS,2,2,0,413163,100%
1085,MLM-VEHICLE_BRAKE_DISCS,73,67,0,413163,100%
1088,MLM-MEMORY_CARD_CASES_AND_BAGS,7,17,0,413163,100%
1090,MLM-CAR_AC_HOSE_ASSEMBLIES,76,74,0,413163,100%
1091,MLM-BABY_CORNER_GUARDS,25,38,0,413163,100%
1094,MLM-SCAFFOLDS,9,22,0,413163,100%
1095,MLM-AUTOMOTIVE_FUEL_TANK_DOORS,40,40,0,413163,100%
1098,MLM-AV_RECEIVERS,57,46,0,413163,100%
1100,MLM-RABBITS,24,46,0,413163,100%
1101,MLM-MOTORCYCLE_BLOCK_CYLINDERS,40,37,0,413163,100%
1103,MLM-MAKEUP_PRIMERS,54,44,0,413163,100%
1104,MLM-HAND_FANS,88,180,0,413163,100%
1105,MLM-MINERAL_WATERS,15,11,0,413163,100%
1107,MLM-ANTIQUE_TELEPHONES,14,17,0,413163,100%
1109,MLM-SINGING_BOWLS,9,33,0,413163,100%
1110,MLM-CAR_AC_EVAPORATOR_CORES,15,26,0,413163,100%
1112,MLM-MANUAL_PAD_PRINTING_MACHINES,5,10,0,413163,100%
1113,MLM-MAGAZINES,52,40,0,413163,100%
1115,MLM-PAINTBALL_SMOKE_GRENADES,10,12,0,413163,100%
1116,MLM-VACUUM_CLEANER_BAGS,4,10,0,413163,100%
1119,MLM-JEWELRY_DISPLAYS_AND_BOXES,12,19,0,413163,100%
1120,MLM-FLOOR_DEODORIZERS,8,11,0,413163,100%
1122,MLM-POWDER_AND_GRAIN_DOSING_MACHINES,2,1,0,413163,100%
1123,MLM-DEVELOPMENT_HOUSES_FOR_SALE,33,34,0,413163,100%
1124,MLM-HELIUM_TANKS,19,19,0,413163,100%
1127,MLM-MARTIAL_ARTS_AND_BOXING_SHOES,29,52,0,413163,100%
1128,MLM-SUSPENSION_CONTROL_ARM_BUSHINGS,118,137,0,413163,100%
1130,MLM-CATS_AND_DOGS_TREATS,14,15,0,413163,100%
1131,MLM-EROTIC_MOVIES,26,31,0,413163,100%
1134,MLM-AUTOMOTIVE_BED_COVERS,41,56,0,413163,100%
1135,MLM-AUTOMOTIVE_INTERIOR_DOOR_HANDLES,104,121,0,413163,100%
1136,MLM-POKER_CHIPS,19,25,0,413163,100%
1137,MLM-YERBA_MATE,28,56,0,413163,100%
1139,MLM-PET_COLLARS,92,101,0,413163,100%
1140,MLM-MOTORCYCLE_AIR_FILTERS,33,36,0,413163,100%
1141,MLM-VIDEO_PLAYER_REMOTE_CONTROLS,9,9,0,413163,100%
1144,MLM-JOKE_TOYS,22,20,0,413163,100%
1146,MLM-BICYCLE_TIRES,88,50,0,413163,100%
1147,MLM-INDUSTRIAL_FOOD_PROCESSORS,1,0,0,413163,100%
1149,MLM-DESKTOP_COMPUTER_CASES,23,29,0,413163,100%
1150,MLM-BIRD_CAGES,27,25,0,413163,100%
1151,MLM-FALSE_CEILINGS,1,2,0,413163,100%
1152,MLM-ACCORDIONS,105,130,0,413163,100%
1153,MLM-TOY_DRUMS,22,23,0,413163,100%
1155,MLM-SHOWER_CURTAINS,57,95,0,413163,100%
1158,MLM-SWIMMING_FINS,15,8,0,413163,100%
1159,MLM-KITCHEN_BOWLS,15,14,0,413163,100%
1160,MLM-MOTORCYCLE_FAIRINGS,24,18,0,413163,100%
1161,MLM-TOY_TRAINS,58,91,0,413163,100%
1162,MLM-SOIL_THERMOMETERS,3,6,0,413163,100%
1163,MLM-FOOTBALL_KITS,90,174,0,413163,100%
1164,MLM-GYMNASTIC_AND_PILATES_HOOPS,9,8,0,413163,100%
1168,MLM-AUTOMOTIVE_ENGINE_CYLINDER_HEADS,19,15,0,413163,100%
1169,MLM-TRAILERS,56,46,0,413163,100%
1171,MLM-FISHING_HOOKS,19,24,0,413163,100%
1172,MLM-FLOORS_WALLS_AND_APERTURES,69,85,0,413163,100%
1173,MLM-ALTERNATIVE_THERAPY_EQUIPMENT,78,74,0,413163,100%
1174,MLM-ELECTRONIC_DRUMS,27,20,0,413163,100%
1175,MLM-FISHES,153,205,0,413163,100%
1176,MLM-HIKING_BOOTS,12,22,0,413163,100%
1177,MLM-WELDING_BLOWTORCHES,26,52,0,413163,100%
1178,MLM-TRAMPOLINE_SPRINGS,10,9,0,413163,100%
1179,MLM-BRAKE_MASTER_CYLINDERS,24,41,0,413163,100%
1180,MLM-IRRIGATION_SPRINKLERS,48,54,0,413163,100%
1181,MLM-OUTER_TIE_ROD_ENDS,23,34,0,413163,100%
1184,MLM-TV_STORAGE_UNITS,165,327,0,413163,100%
1185,MLM-WASHING_AND_DRYER_MACHINE_COVERS,7,11,0,413163,100%
1186,MLM-WATER_TANKS,39,43,0,413163,100%
1187,MLM-SPORTS_DRINKS,11,24,0,413163,100%
1188,MLM-AUTOMOTIVE_RADIATOR_SUPPORTS,46,57,0,413163,100%
1189,MLM-PEDAL_EFFECTS,51,75,0,413163,100%
1190,MLM-PICTURE_FRAMES,78,155,0,413163,100%
1192,MLM-AUTOMOTIVE_SPEED_SENSORS,40,46,0,413163,100%
1193,MLM-CAR_TURN_SIGNAL_LIGHTS,77,115,0,413163,100%
1194,MLM-ANTIBACTERIAL_GELS,15,4,0,413163,100%
1196,MLM-RATTLES,29,42,0,413163,100%
1198,MLM-PREGNANCY_AND_OVULATION_TESTS,22,38,0,413163,100%
1200,MLM-PARKING_BRAKE_HANDLES,22,25,0,413163,100%
1201,MLM-STOOLS,94,113,0,413163,100%
1204,MLM-TALCUMS,6,6,0,413163,100%
1205,MLM-REFRIGERATOR_AND_FREEZER_SENSORS,5,5,0,413163,100%
1206,MLM-INDUSTRIAL_EXHAUST_FANS,31,33,0,413163,100%
1214,MLM-DINING_TABLES,102,103,0,413163,100%
1218,MLM-BILLIARD_TABLES,64,138,0,413163,100%
1219,MLM-AUTOMOTIVE_SPEAKER_BOXES,67,71,0,413163,100%
1220,MLM-DOG_LEASHES,60,74,0,413163,100%
1223,MLM-INDUSTRIAL_ATOMIZER_MILLS,7,7,0,413163,100%
1227,MLM-AUTOMOTIVE_DEFLECTORS,106,125,0,413163,100%
1229,MLM-MOTORCYCLE_LICENSE_PLATE_BRACKETS,6,6,0,413163,100%
1231,MLM-AUTOMOTIVE_EXTERIOR_DOOR_HANDLES,119,160,0,413163,100%
1232,MLM-TELEVISION_MAIN_PLATE_REPLACEMENTS,85,83,0,413163,100%
1233,MLM-AUTOMOTIVE_HEATER_HOSES,22,29,0,413163,100%
1234,MLM-BASKETBALL_JERSEYS,55,76,0,413163,100%
1235,MLM-HAND_WIRE_BRUSHES,4,5,0,413163,100%
1237,MLM-FLAGS,34,58,0,413163,100%
1241,MLM-CATALOGS,3,3,0,413163,100%
1242,MLM-NON_SLIP_TAPES,13,17,0,413163,100%
1243,MLM-BICYCLE_FRAMES,81,121,0,413163,100%
1244,MLM-RETAIL_SPACE_FOR_SALE,7,11,0,413163,100%
1246,MLM-TUBE_BENDERS,5,2,0,413163,100%
1248,MLM-HYDROPONIC_FOAMS,4,7,0,413163,100%
1249,MLM-FURNITURE_DOOR_AND_WINDOW_HINGES,41,41,0,413163,100%
1250,MLM-CHRISTMAS_DOLLS,92,94,0,413163,100%
1252,MLM-MOTORCYCLE_WINDSHIELDS,21,16,0,413163,100%
1253,MLM-HOUSE_NUMBERS,10,10,0,413163,100%
1254,MLM-LAPTOP_HINGES,13,17,0,413163,100%
1255,MLM-CNC_LATHES,10,11,0,413163,100%
1257,MLM-WATER_BEADS,12,9,0,413163,100%
1259,MLM-CONTAINER_CAPS_AND_PLUGS,5,4,0,413163,100%
1261,MLM-OFFICES_FOR_RENT,10,12,0,413163,100%
1262,MLM-FIREFIGHTER_UNIFORMS,3,5,0,413163,100%
1265,MLM-WALKMANS,37,32,0,413163,100%
1267,MLM-AUTOMOTIVE_ENGINE_COOLANT_THERMOSTATS,51,86,0,413163,100%
1269,MLM-DENTAL_CURING_LIGHTS,4,2,0,413163,100%
1270,MLM-ELECTRICAL_BALLASTS,3,0,0,413163,100%
1271,MLM-DECORATIVE_PANELS,25,29,0,413163,100%
1272,MLM-GLASSES_REPLACEMENT_LENSES,19,44,0,413163,100%
1281,MLM-SELF_CONTAINED_BREATHING_APPARATUS,2,2,0,413163,100%
1284,MLM-MOTORCYCLE_ENGINES,22,29,0,413163,100%
1285,MLM-FISH_TANK_THERMOMETERS,9,20,0,413163,100%
1288,MLM-KIDS_PLAYSETS,20,45,0,413163,100%
1289,MLM-LIP_BALMS,31,47,0,413163,100%
1290,MLM-BABY_ACTIVITY_CENTERS,36,45,0,413163,100%
1291,MLM-CONFETTI_SHOOTERS,12,29,0,413163,100%
1295,MLM-SPORT_SKIRTS,9,10,0,413163,100%
1297,MLM-DRYER_MACHINES,38,49,0,413163,100%
1300,MLM-FONDUE_SETS,7,4,0,413163,100%
1301,MLM-PRECIOUS_AND_SEMI_PRECIOUS_STONES,149,180,0,413163,100%
1303,MLM-BALSAMIC_VINEGARS,1,1,0,413163,100%
1306,MLM-CAR_CUP_HOLDERS,102,153,0,413163,100%
1308,MLM-MUSICAL_ORGANS,10,1,0,413163,100%
1309,MLM-LANDS_FOR_RENT,15,15,0,413163,100%
1310,MLM-PENCIL_SHARPENERS,21,27,0,413163,100%
1314,MLM-NIGHTSTANDS,72,84,0,413163,100%
1315,MLM-DUSTERS,6,6,0,413163,100%
1316,MLM-NATIVITY_SCENES,38,46,0,413163,100%
1317,MLM-HAND_TRUCKS,26,49,0,413163,100%
1320,MLM-MEATS,46,84,0,413163,100%
1321,MLM-CELLPHONE_CAMERA_REPLACEMENT_LENSES,29,77,0,413163,100%
1322,MLM-DREAMCATCHERS,16,31,0,413163,100%
1323,MLM-SANDPAPERS,91,119,0,413163,100%
1324,MLM-BICYCLE_RIMS,79,99,0,413163,100%
1325,MLM-HAND_BLENDERS,22,30,0,413163,100%
1327,MLM-MOTORCYCLE_TAIL_LIGHTS,26,30,0,413163,100%
1328,MLM-AUTOMOTIVE_WIRE_HARNESSES,100,118,0,413163,100%
1329,MLM-PROJECTOR_LAMPS,18,17,0,413163,100%
1330,MLM-FISHING_SINKERS,4,3,0,413163,100%
1331,MLM-DRILL_STANDS,24,34,0,413163,100%
1332,MLM-PACKAGING_ROLLS,25,25,0,413163,100%
1333,MLM-BONGOS,13,24,0,413163,100%
1334,MLM-ELECTRONIC_ENTRANCE_INTERCOMS,61,79,0,413163,100%
1335,MLM-AUTOMOTIVE_OXYGEN_SENSORS,67,59,0,413163,100%
1339,MLM-JUKEBOXES,60,74,0,413163,100%
1340,MLM-PET_WHEELCHAIRS,8,15,0,413163,100%
1341,MLM-MOTORCYCLE_LIGHT_SWITCHES,11,17,0,413163,100%
1342,MLM-KITCHEN_CABINETS,298,387,0,413163,100%
1343,MLM-HOLE_PUNCHES,32,40,0,413163,100%
1344,MLM-HOME_KNITTING_MACHINES,1,1,0,413163,100%
1345,MLM-RADIATOR_CAPS,35,38,0,413163,100%
1346,MLM-WOOD_FLOORINGS,44,50,0,413163,100%
1347,MLM-MOTORCYCLE_ENGINE_CAMSHAFTS,5,6,0,413163,100%
1348,MLM-NAIL_STRENGTHENERS,7,11,0,413163,100%
1350,MLM-WATER_AND_EXTREME_SPORTS_EQUIPMENT,34,36,0,413163,100%
1351,MLM-MEDICAL_EXAM_TABLES,19,26,0,413163,100%
1354,MLM-EROTIC_MALE_UNDERWEAR,16,7,0,413163,100%
1355,MLM-THERMAL_REFRIGERATORS_AND_BAGS,122,185,0,413163,100%
1356,MLM-AUTOMOTIVE_DOOR_LATCHES,50,65,0,413163,100%
1358,MLM-BABY_BIBS,45,79,0,413163,100%
1359,MLM-BRICKS,23,27,0,413163,100%
1361,MLM-EAR_TAG_APPLICATORS,6,9,0,413163,100%
1362,MLM-NAIL_STAMPING_PLATES,35,55,0,413163,100%
1364,MLM-TRUCKS,151,177,0,413163,100%
1368,MLM-TREADMILL_RUNNING_BELTS,2,2,0,413163,100%
1369,MLM-FIBER_OPTIC_POWER_METERS,2,3,0,413163,100%
1372,MLM-PLACEMATS,41,63,0,413163,100%
1373,MLM-TOOL_POUCHES,43,53,0,413163,100%
1374,MLM-COMBUSTION_WATER_PUMPS,37,21,0,413163,100%
1375,MLM-BABY_GROOMING_KITS,13,22,0,413163,100%
1378,MLM-FILING_CABINETS,32,28,0,413163,100%
1379,MLM-PIANOS,48,53,0,413163,100%
1381,MLM-AUTOMOTIVE_WEATHERSTRIPS,109,131,0,413163,100%
1383,MLM-CONSTRUCTION_MACHINERY,30,30,0,413163,100%
1385,MLM-WAREHOUSES_FOR_RENT,6,4,0,413163,100%
1391,MLM-ICE_BUCKETS,4,6,0,413163,100%
1392,MLM-HEARING_PROTECTORS,27,34,0,413163,100%
1393,MLM-MAKEUP_ILLUMINATORS,38,36,0,413163,100%
1394,MLM-3D_GLASSES,20,23,0,413163,100%
1396,MLM-MOTORCYCLE_FENDERS,50,73,0,413163,100%
1397,MLM-3D_PENS,22,44,0,413163,100%
1399,MLM-TEST_TUBE_RACKS,3,1,0,413163,100%
1400,MLM-CANDLE_WAXES,3,0,0,413163,100%
1401,MLM-MANUAL_TRANSMISSION_SHIFT_LEVER_BOOTS,7,9,0,413163,100%
1402,MLM-AUTOMOTIVE_MANUAL_WINDOW_REGULATOR_SYSTEMS,14,17,0,413163,100%
1403,MLM-ELEVATED_PLATFORMS,10,12,0,413163,100%
1404,MLM-HAIR_REMOVAL,20,45,0,413163,100%
1405,MLM-PASTEL_PAINTS,13,28,0,413163,100%
1407,MLM-BABY_BLANKETS,45,83,0,413163,100%
1408,MLM-WATCH_BOXES,3,2,0,413163,100%
1410,MLM-ACTION_CAMERA_MOUNTS,34,50,0,413163,100%
1412,MLM-VOLTAGE_CONVERTERS,26,36,0,413163,100%
1414,MLM-DOOR_AND_WINDOW_LATCHES,7,7,0,413163,100%
1416,MLM-KITES,2,2,0,413163,100%
1417,MLM-REUSABLE_ICE_CUBES,15,10,0,413163,100%
1418,MLM-ELECTRIC_SANDWICH_MAKERS,19,22,0,413163,100%
1419,MLM-MOTORCYCLE_JERSEYS,55,39,0,413163,100%
1420,MLM-KIDS_PLAYHOUSES,96,135,0,413163,100%
1421,MLM-KITCHEN_RANGE_HOODS,45,80,0,413163,100%
1422,MLM-SUP_BOARDS,2,1,0,413163,100%
1425,MLM-AUTOMOTIVE_AC_CONTROL_PANELS,24,20,0,413163,100%
1426,MLM-FURNITURE_GLIDES,14,15,0,413163,100%
1428,MLM-BEARD_KITS,20,28,0,413163,100%
1431,MLM-INDUCTIVE_SENSORS,14,21,0,413163,100%
1433,MLM-CUTICLE_PUSHERS,6,4,0,413163,100%
1434,MLM-KEYBOARD_CONTROLLERS,30,18,0,413163,100%
1437,MLM-MODEL_RAILROADING_TRACKS,7,4,0,413163,100%
1438,MLM-MONOCULARS,29,45,0,413163,100%
1439,MLM-AIR_FRESHENERS,31,24,0,413163,100%
1440,MLM-GRAVY_BOATS,12,19,0,413163,100%
1441,MLM-LETTER_TRAYS,11,17,0,413163,100%
1442,MLM-AUTOMOTIVE_ROOF_CARGO_BASKETS,66,121,0,413163,100%
1443,MLM-MOTORCYCLE_VOLTAGE_REGULATORS,16,18,0,413163,100%
1445,MLM-CONCERTINA_WIRES,17,34,0,413163,100%
1446,MLM-DRAWING_BOARDS_AND_TABLES,18,22,0,413163,100%
1448,MLM-LOCKERS,23,45,0,413163,100%
1449,MLM-PET_TOY_BALLS,7,6,0,413163,100%
1450,MLM-MARTIAL_ARTS_FOCUS_MITTS_AND_RACKETS,16,21,0,413163,100%
1451,MLM-AUTOMOTIVE_TIMING_BELTS,25,38,0,413163,100%
1452,MLM-PATIO_FURNITURE_SETS,17,23,0,413163,100%
1453,MLM-BICYCLE_BAGS,32,54,0,413163,100%
1456,MLM-AUTOMOTIVE_HEAD_GASKETS,20,14,0,413163,100%
1458,MLM-MOTORCYCLE_IGNITION_COILS,9,8,0,413163,100%
1459,MLM-HAIR_REMOVAL_KITS,14,20,0,413163,100%
1460,MLM-PARTY_GLASSES,28,41,0,413163,100%
1461,MLM-MEASURING_CUPS_AND_JUGS,14,26,0,413163,100%
1462,MLM-ABS_SENSORS,33,27,0,413163,100%
1465,MLM-CROSSBREED_DOGS,16,11,0,413163,100%
1469,MLM-CELLPHONE_AND_TABLET_MOTHERBOARDS,87,98,0,413163,100%
1471,MLM-COLLECTIBLE_PHONE_CARDS,12,8,0,413163,100%
1472,MLM-AMBULANCE_STRETCHERS,23,22,0,413163,100%
1476,MLM-CLEANING_TROLLEYS,4,3,0,413163,100%
1477,MLM-MOTORCYCLE_SEAT_COVERS,23,41,0,413163,100%
1479,MLM-GREASE_TRAPS,12,33,0,413163,100%
1480,MLM-DRUMHEADS,41,40,0,413163,100%
1481,MLM-IRONING_BOARDS,37,47,0,413163,100%
1483,MLM-MOTORCYCLE_BRAKE_MASTER_CYLINDER_RESERVOIRS,2,3,0,413163,100%
1484,MLM-CORRECTION_TAPES_AND_FLUIDS,6,12,0,413163,100%
1485,MLM-TELEPHONE_CABLES,17,23,0,413163,100%
1486,MLM-SWIM_CAPS,23,32,0,413163,100%
1487,MLM-AUTOMOTIVE_HAZARD_WARNING_SWITCHES,21,17,0,413163,100%
1490,MLM-BAKERY_RACKS,13,7,0,413163,100%
1491,MLM-AUTOMOTIVE_BATTERY_JUMPER_CABLES,27,41,0,413163,100%
1492,MLM-PRINTER_PICK_UP_ROLLERS,4,5,0,413163,100%
1493,MLM-ICE_MAKERS,27,41,0,413163,100%
1495,MLM-NAIL_POLISH_REMOVERS,10,13,0,413163,100%
1496,MLM-IDLER_ARMS,10,12,0,413163,100%
1497,MLM-TAPE_MEASURES,21,22,0,413163,100%
1499,MLM-TOY_BOWS_AND_ARROWS,5,4,0,413163,100%
1500,MLM-LAUNDRY_BASKETS,23,14,0,413163,100%
1502,MLM-WOODEN_CRATES,49,89,0,413163,100%
1503,MLM-GARDENING,104,134,0,413163,100%
1505,MLM-WALL_ANCHOR_PLUGS,25,30,0,413163,100%
1506,MLM-EASELS,11,22,0,413163,100%
1507,MLM-SPORT_AND_SECURITY_WHISTLES,35,88,0,413163,100%
1509,MLM-BIRD_DRINKERS_AND_FEEDERS,63,75,0,413163,100%
1510,MLM-COMBUSTION_PRESSURE_WASHERS,24,44,0,413163,100%
1513,MLM-TREAT_DISPENSING_PET_TOYS,11,3,0,413163,100%
1514,MLM-KIDS_EASELS,14,13,0,413163,100%
1516,MLM-LAPTOP_POWER_BUTTON_BOARDS,2,1,0,413163,100%
1517,MLM-VEHICLE_CARBURETOR_ACCELERATOR_CABLES,17,19,0,413163,100%
1518,MLM-MAF_SENSORS,43,49,0,413163,100%
1520,MLM-BABY_JUMPERS,13,10,0,413163,100%
1522,MLM-HYDROPONIC_NUTRIENTS,11,12,0,413163,100%
1523,MLM-SPORT_WEIGHT_VESTS,42,78,0,413163,100%
1525,MLM-3D_PRINTER_NOZZLES,68,88,0,413163,100%
1526,MLM-RODENT_TOYS,56,86,0,413163,100%
1527,MLM-MIRRORS,75,124,0,413163,100%
1528,MLM-HOOD_LOCKS,17,22,0,413163,100%
1529,MLM-BABY_TOWELS,4,3,0,413163,100%
1530,MLB-CARS_AND_VANS,41420,65013,0,413163,100%
1534,MLB-AUTOMOTIVE_DEGREASERS,83,110,0,413163,100%
1536,MLM-ANGLE_FINDERS,13,20,0,413163,100%
1537,MLM-COURSES,16,20,0,413163,100%
1544,MLM-COMMERCIAL_LIGHT_SIGNS,21,29,0,413163,100%
1546,MLM-GAME_CONSOLE_CAMERAS_AND_SENSOR_BARS,33,43,0,413163,100%
1548,MLM-VEHICLE_CLUTCH_CABLES,6,6,0,413163,100%
1553,MLM-ECG_MACHINES,4,2,0,413163,100%
1554,MLM-MEAT_GRINDERS,45,18,0,413163,100%
1555,MLM-MODEL_RAILROADING_LOCOMOTIVES,27,29,0,413163,100%
1556,MLM-ENGINE_OIL_PRESSURE_SENSORS,33,26,0,413163,100%
1557,MLB-CPAP_MACHINES,61,45,0,413163,100%
1567,MLB-HIP_SCARVES,35,59,0,413163,100%
1571,MLM-BICYCLE_SPOKES,2,3,0,413163,100%
1572,MLM-CAR_CENTER_CONSOLES,55,140,0,413163,100%
1577,MLB-TRUMPETS,128,157,0,413163,100%
1582,MLM-MODELISM_WAR_TANKS,8,5,0,413163,100%
1583,MLM-TABLE_BASES,3,4,0,413163,100%
1584,MLM-MOTORCYCLE_GEARBOXES,13,20,0,413163,100%
1586,MLM-TABLE_DRILLS,65,101,0,413163,100%
1588,MLM-BASKETBALL_BACKBOARDS_AND_HOOPS,26,34,0,413163,100%
1590,MLM-TOOL_ORGANIZERS,2,1,0,413163,100%
1592,MLM-MASSAGE_SOFAS,9,8,0,413163,100%
1600,MLB-CIGARETTE_FILTERS,74,107,0,413163,100%
1603,MLM-FOOD_SLICERS,36,26,0,413163,100%
1604,MLM-FERTILE_BIRD_EGGS,5,7,0,413163,100%
1605,MLM-PHOTOGRAPHIC_MINILABS,17,10,0,413163,100%
1606,MLM-TAB_GRABBERS,3,3,0,413163,100%
1607,MLM-MICROWAVES,78,107,0,413163,100%
1608,MLM-CO2_LASER_TUBES,5,4,0,413163,100%
1610,MLM-TV_REPLACEMENT_BACKLIGHT_LED_STRIPS,90,60,0,413163,100%
1612,MLM-CELLOS,4,4,0,413163,100%
1613,MLM-CHOCOLATE_WATERFALLS,14,16,0,413163,100%
1615,MLM-LAPTOP_SKINS,34,40,0,413163,100%
1619,MLM-AUTOMOTIVE_FUEL_PRESSURE_REGULATORS,23,19,0,413163,100%
1622,MLM-FOOSBALL_TABLES,35,47,0,413163,100%
1624,MLM-CHALKBOARDS_AND_WHITEBOARDS,33,52,0,413163,100%
1625,MLM-DECORATIVE_BOXES,16,24,0,413163,100%
1626,MLM-TABLE_TENNIS_RACKETS,10,7,0,413163,100%
1627,MLM-CHARANGOS,9,0,0,413163,100%
1628,MLM-BICYCLE_FORKS,38,33,0,413163,100%
1630,MLM-CAR_BODY_SCOOPS,28,35,0,413163,100%
1632,MLM-MICRO_ROTARY_TOOL_KITS,12,33,0,413163,100%
1633,MLM-NAIL_TAPES,22,41,0,413163,100%
1634,MLM-AUTOMOTIVE_SPARE_TIRE_SUPPORTS,5,6,0,413163,100%
1636,MLM-LOADERS,6,1,0,413163,100%
1637,MLM-TEA_INFUSERS,46,118,0,413163,100%
1638,MLM-PLASTERING_MACHINES,5,3,0,413163,100%
1639,MLM-KITCHEN_SPOONS,27,29,0,413163,100%
1640,MLM-OTOSCOPES,23,26,0,413163,100%
1641,MLM-TENNIS_WRISTBANDS,2,1,0,413163,100%
1642,MLM-AUTOMOTIVE_ENGINE_TIMING_COVERS,11,12,0,413163,100%
1643,MLM-AUTOMOTIVE_FENDERS,68,77,0,413163,100%
1645,MLM-KITCHEN_KNIVES,15,18,0,413163,100%
1647,MLM-ELECTRIC_GRAIN_MILLS,8,8,0,413163,100%
1648,MLM-DRUM_PEDALS,16,14,0,413163,100%
1649,MLM-LAMP_HOLDERS,29,28,0,413163,100%
1650,MLM-POP_FILTERS,8,11,0,413163,100%
1651,MLM-POOL_PUMPS,9,13,0,413163,100%
1652,MLM-ENGINE_VALVES_SPRING_RETAINERS,17,18,0,413163,100%
1656,MLM-TABLET_BATTERIES,17,27,0,413163,100%
1657,MLM-NETWORK_HUBS,7,14,0,413163,100%
1660,MLM-COUGH_COLD_AND_FLU_MEDICINES,3,3,0,413163,100%
1661,MLM-PORTABLE_GAME_CONSOLE_REPLACEMENT_SCREENS,6,0,0,413163,100%
1662,MLM-CULINARY_UNIFORMS,17,34,0,413163,100%
1663,MLM-FISHING_REELS,26,25,0,413163,100%
1665,MLM-POOL_LIGHTS,27,36,0,413163,100%
1666,MLM-AUTOMOTIVE_STEERING_WHEEL_SPINNERS,28,46,0,413163,100%
1670,MLM-WAGONS,2,1,0,413163,100%
1671,MLM-SAFETY_TRIANGLES,3,4,0,413163,100%
1673,MLM-DRILL_CHUCKS,26,30,0,413163,100%
1674,MLM-WINDSHIELDS,20,56,0,413163,100%
1675,MLM-MAP_SENSORS,24,42,0,413163,100%
1676,MLM-EROTIC_COSTUMES,31,16,0,413163,100%
1677,MLM-AUTOMOTIVE_GEARBOX_MOUNT_BRACKETS,105,111,0,413163,100%
1681,MLM-CABLE_TRACKERS,3,3,0,413163,100%
1682,MLM-WORK_COVERALLS_AND_OVERALLS,9,22,0,413163,100%
1683,MLM-ELECTRIC_HAND_PLANERS,25,32,0,413163,100%
1684,MLM-SOUND_CONSOLES_AND_DJ_MIXERS,37,41,0,413163,100%
1685,MLM-FOOTWEAR_CLEANERS_AND_POLISHES,3,8,0,413163,100%
1686,MLM-CORN_KERNELS,6,5,0,413163,100%
1687,MLM-BALANCE_BICYCLES,13,17,0,413163,100%
1688,MLM-SPEAKER_GRILLS,4,2,0,413163,100%
1689,MLM-ORTHODONTIC_WAXES,6,8,0,413163,100%
1690,MLM-MANUAL_HAMMERS,32,29,0,413163,100%
1691,MLM-MAGNETIC_DRAWING_BOARDS,7,6,0,413163,100%
1692,MLM-TOY_SWORDS,19,23,0,413163,100%
1694,MLM-PEACOCKS,9,7,0,413163,100%
1695,MLM-EXAM_ROOM_FURNITURE_SETS,17,5,0,413163,100%
1696,MLM-ANTIQUE_CASH_REGISTERS,2,2,0,413163,100%
1697,MLM-PLASMA_CUTTER_CONSUMABLES_SETS,5,6,0,413163,100%
1699,MLM-MANUAL_LINT_REMOVERS,22,48,0,413163,100%
1701,MLM-POKER_TABLES,43,83,0,413163,100%
1703,MLM-FOLDERS_AND_EXPANDING_FILES,77,101,0,413163,100%
1704,MLM-HACKSAW_BLADES,15,16,0,413163,100%
1706,MLM-CAR_WINDOW_SWITCHES,76,101,0,413163,100%
1707,MLM-COLD_ROOMS,12,11,0,413163,100%
1708,MLM-TELESCOPES,109,134,0,413163,100%
1709,MLM-AQUARIUM_LIGHTS,35,39,0,413163,100%
1710,MLM-DRUMS,36,39,0,413163,100%
1712,MLM-AUTOMOTIVE_WINDOW_CRANK_HANDLES,22,31,0,413163,100%
1713,MLM-MOTORHOMES,26,35,0,413163,100%
1715,MLM-CIGAR_CUTTERS,9,10,0,413163,100%
1716,MLM-SURFBOARDS,11,9,0,413163,100%
1717,MLM-EYEBROW_LINERS,51,79,0,413163,100%
1718,MLM-TACTICAL_PANTS,13,5,0,413163,100%
1719,MLM-CARPET_AND_UPHOLSTERY_CLEANERS,12,15,0,413163,100%
1720,MLM-AUTOMOTIVE_MUD_GUARDS,72,73,0,413163,100%
1724,MLM-ROBOT_VACUUMS,29,37,0,413163,100%
1727,MLM-PET_CLIPPER_REPLACEMENT_BLADES,7,9,0,413163,100%
1728,MLM-AUTOMOTIVE_TAIL_LIGHT_LENSES,39,30,0,413163,100%
1730,MLM-MOTORCYCLE_WHEEL_AXLES,17,18,0,413163,100%
1731,MLM-DIMMERS,11,13,0,413163,100%
1732,MLM-AUTOMOTIVE_HEATER_VALVES,18,8,0,413163,100%
1733,MLM-MOTORCYCLE_STANDS,17,10,0,413163,100%
1734,MLM-PHEROMONE_CONCENTRATES,5,13,0,413163,100%
1736,MLM-EXHAUST_MANIFOLDS,4,3,0,413163,100%
1737,MLM-GAME_CONSOLE_REPLACEMENT_MOTORS,1,0,0,413163,100%
1738,MLM-HAND_AND_FOOT_CREAMS,47,60,0,413163,100%
1739,MLM-GAS_LAWN_MOWERS,24,38,0,413163,100%
1740,MLM-ELECTRIC_BLOWERS,33,67,0,413163,100%
1741,MLM-DRONE_ANTENNAS,3,4,0,413163,100%
1742,MLM-ENGINE_CRANKSHAFT_POSITION_SENSORS,46,47,0,413163,100%
1743,MLM-PRINTER_SERVERS,13,16,0,413163,100%
1746,MLM-MOTORCYCLE_WHEELS,28,34,0,413163,100%
1764,MLM-BREAKFASTS_AND_AFTERNOON_TEAS,9,14,0,413163,100%
1765,MLM-HAIRDRESSING_CLIPS,19,28,0,413163,100%
1766,MLM-BABY_REPELLENT_BUTTONS,10,18,0,413163,100%
1767,MLM-HAMBURGER_PRESSES,1,1,0,413163,100%
1769,MLM-AUTOMOTIVE_REAR_BUMPERS,95,80,0,413163,100%
1770,MLM-ELECTRIC_MASSAGE_PILLOWS,1,2,0,413163,100%
1771,MLM-COLLECTIBLE_SWORDS,98,99,0,413163,100%
1776,MLB-HOOKAH_BOWLS,153,327,0,413163,100%
1781,MLM-ROLL_BARS,21,22,0,413163,100%
1782,MLM-AUTOMOTIVE_DOORS,20,13,0,413163,100%
1785,MLM-COMMERCIAL_NO_LIGHT_SIGNS,21,18,0,413163,100%
1786,MLM-MOTORCYCLE_STARTER_SWITCH_IGNITIONS,28,51,0,413163,100%
1787,MLM-BEDLINERS,9,5,0,413163,100%
1788,MLM-MEZCALS,35,36,0,413163,100%
1789,MLM-BABY_BASSINETS_AND_MOSES_BASKETS,44,36,0,413163,100%
1790,MLM-CLAMP_METERS,31,52,0,413163,100%
1791,MLM-PHOTOCOPIERS,58,59,0,413163,100%
1802,MLM-MEASURING_WHEELS,9,12,0,413163,100%
1804,MLM-CABIN_FILTERS,25,25,0,413163,100%
1805,MLM-TACTICAL_HELMETS,25,68,0,413163,100%
1807,MLM-LASER_KEYBOARDS,13,26,0,413163,100%
1808,MLM-BASEBOARDS,12,11,0,413163,100%
1809,MLM-GRAIN_GRINDING_MACHINES,3,3,0,413163,100%
1810,MLM-MOTORCYCLE_CRASH_BARS,65,78,0,413163,100%
1814,MLM-CNC_MACHINING_CENTERS,20,26,0,413163,100%
1816,MLM-MARTIAL_ARTS_BELTS,8,9,0,413163,100%
1817,MLM-BICYCLE_BOTTLE_CAGES,8,20,0,413163,100%
1819,MLM-KEYBOARD_AND_DIGITAL_PIANO_STANDS,10,3,0,413163,100%
1821,MLM-FOOD_AND_DRINK_COLORINGS,11,6,0,413163,100%
1822,MLM-ASHTRAYS,23,29,0,413163,100%
1825,MLM-BATHROOM_ACCESSORIES_SETS,40,77,0,413163,100%
1826,MLM-MINI_PCS,73,108,0,413163,100%
1827,MLM-INDUSTRIAL_MAGNETS,35,50,0,413163,100%
1829,MLM-MICROCONTROLLERS,33,43,0,413163,100%
1830,MLM-SMARTWATCH_BATTERIES,3,3,0,413163,100%
1831,MLM-SCREWDRIVERS_SETS,30,36,0,413163,100%
1833,MLM-METAL_NAILS,5,7,0,413163,100%
1834,MLM-CABLE_ORGANIZER_BAGS,14,23,0,413163,100%
1835,MLM-PLASTIC_GRINDING_MACHINES,4,2,0,413163,100%
1838,MLM-FISHING_VESTS,14,19,0,413163,100%
1839,MLM-AUTOMOTIVE_ENGINE_OIL_PANS,18,24,0,413163,100%
1840,MLM-CUTTING_PLIERS,43,50,0,413163,100%
1841,MLM-MAKEUP_VANITIES,70,106,0,413163,100%
1851,MLM-AUDIO_CROSSOVERS,15,15,0,413163,100%
1852,MLM-GYM_WEIGHT_AND_BAR_RACKS,15,13,0,413163,100%
1855,MLM-FOOT_BATH_MASSAGERS,28,52,0,413163,100%
1857,MLM-CANTEENS,16,31,0,413163,100%
1858,MLM-TIMBALES,11,12,0,413163,100%
1859,MLM-HAND_HELD_REFRACTOMETERS,8,12,0,413163,100%
1860,MLM-FALSE_NAILS,59,54,0,413163,100%
1861,MLM-FLUTES,33,48,0,413163,100%
1862,MLM-COLLECTIBLE_CANS_BOTTLES_AND_SODA_SIPHONS,47,68,0,413163,100%
1863,MLM-BATHROOM_VANITIES,37,64,0,413163,100%
1865,MLM-ADULT_MANUAL_TRICYCLES,28,91,0,413163,100%
1866,MLM-SWIMMING_GLOVES_AND_PADDLES,9,14,0,413163,100%
1867,MLM-EQUALIZERS,21,26,0,413163,100%
1868,MLM-AUTOMOTIVE_TURN_SIGNAL_LIGHT_LENSES,3,1,0,413163,100%
1871,MLB-FALSE_CEILINGS,148,388,0,413163,100%
1872,MLM-AIR_CONDITIONER_VALVES,5,3,0,413163,100%
1873,MLM-TILE_CUTTERS,23,30,0,413163,100%
1875,MLM-CHOPSTICKS,17,31,0,413163,100%
1876,MLM-PAPER_SHREDDERS,13,21,0,413163,100%
1877,MLM-VEHICLE_CV_AXLES,26,25,0,413163,100%
1878,MLM-DRONE_BATTERY_CHARGERS,13,13,0,413163,100%
1880,MLM-ALL_TERRAIN_VEHICLE_TIRES,34,37,0,413163,100%
1882,MLM-BUBBLE_MACHINES,11,13,0,413163,100%
1883,MLM-CAR_ENGINE_CAMSHAFTS,16,4,0,413163,100%
1884,MLM-SUBMERSIBLE_PUMPS,54,64,0,413163,100%
1888,MLM-VEHICLE_TIRE_VALVES,5,5,0,413163,100%
1894,MLB-AUTOMOTIVE_FENDERS,376,389,0,413163,100%
1898,MLB-CAR_GEARBOXES,494,634,0,413163,100%
1899,MLM-SALT_AND_PEPPER_SHAKERS,26,48,0,413163,100%
1900,MLM-SECURITY_SPIKES,4,1,0,413163,100%
1901,MLM-BDSM_MASKS,7,0,0,413163,100%
1902,MLM-GAME_CONSOLE_AND_VIDEO_GAME_CONTROLLER_SKINS,36,28,0,413163,100%
1903,MLM-AUTOMOTIVE_OIL_FILTERS,64,57,0,413163,100%
1904,MLM-INDUSTRIAL_FUSES,40,56,0,413163,100%
1905,MLM-CLUTCH_BEARINGS,12,22,0,413163,100%
1906,MLM-BABY_PACIFIER_CLIPS,5,6,0,413163,100%
1907,MLM-CEMENT,19,32,0,413163,100%
1908,MLM-LASER_PRINTER_DRUM_BLADES,3,3,0,413163,100%
1909,MLM-MOTORCYCLE_IGNITION_SWITCHES,14,27,0,413163,100%
1910,MLM-MOTORCYCLE_HELMET_VISORS,32,41,0,413163,100%
1911,MLM-OFFICE_CONFERENCE_TABLES,49,77,0,413163,100%
1912,MLM-LIQUOR_DECANTERS,12,21,0,413163,100%
1913,MLM-ORAL_IRRIGATORS,16,32,0,413163,100%
1914,MLM-NAIL_AND_CUTICLE_CUTTERS,21,29,0,413163,100%
1915,MLM-AUTOMOTIVE_MUFFLERS,91,126,0,413163,100%
1916,MLM-AUTOMOTIVE_SEAT_RECLINER_HANDLES_AND_LEVERS,10,14,0,413163,100%
1919,MLM-REPTILE_AND_AMPHIBIAN_FOODS,11,11,0,413163,100%
1920,MLM-AMERICAN_FOOTBALL_BALLS,33,31,0,413163,100%
1922,MLM-AMERICAN_FOOTBALL_GLOVES,32,22,0,413163,100%
1923,MLM-WINDSHIELD_WIPER_ARMS,24,17,0,413163,100%
1924,MLM-DRUM_STANDS,11,11,0,413163,100%
1925,MLM-ECT_SENSORS,39,41,0,413163,100%
1926,MLM-BEER_FERMENTERS,2,2,0,413163,100%
1927,MLM-TPMS_SENSORS,28,40,0,413163,100%
1929,MLM-RICE_COOKERS,4,4,0,413163,100%
1931,MLM-DOG_TRAINING_WHISTLES,11,5,0,413163,100%
1932,MLM-BABY_SWIMWEAR,13,25,0,413163,100%
1933,MLM-WATERPROOF_CAMERA_CASES,20,36,0,413163,100%
1936,MLM-FLASH_TRIGGERS,9,22,0,413163,100%
1937,MLM-MOTORCYCLE_PANTS,43,53,0,413163,100%
1938,MLM-ELECTRODE_PADS,23,25,0,413163,100%
1939,MLM-RETAIL_SPACE_FOR_RENT,23,34,0,413163,100%
1940,MLM-CAR_POWER_STEERING_PUMPS,56,57,0,413163,100%
1941,MLM-IP_TELEPHONES,12,13,0,413163,100%
1943,MLM-LAPTOP_INVERTERS,8,11,0,413163,100%
1945,MLM-SPARK_PLUG_WIRESETS,70,88,0,413163,100%
1946,MLM-PEANUTS,10,14,0,413163,100%
1947,MLM-HAIR_DRYER_DIFFUSERS,9,27,0,413163,100%
1948,MLM-RADIAL_INDUCTORS,9,6,0,413163,100%
1949,MLM-SUSPENSION_BALL_JOINTS,69,75,0,413163,100%
1950,MLM-WASHING_MACHINE_CONTROL_BOARDS,16,11,0,413163,100%
1951,MLM-TOY_PEDAL_CARS,19,27,0,413163,100%
1966,MLM-PARTY_PROPS,9,17,0,413163,100%
1973,MLB-TRUCKS,5467,8781,0,413163,100%
1979,MLM-MITER_SAWS,20,24,0,413163,100%
1980,MLM-AUTOMOTIVE_TURBOCHARGER_DOWNPIPES,6,7,0,413163,100%
1983,MLM-CONSTRUCTION_PUMPS,54,81,0,413163,100%
1985,MLM-APPETIZER_BOARDS,5,5,0,413163,100%
1986,MLM-PEDAL_EXERCISERS,14,26,0,413163,100%
1987,MLM-OXYGEN_TANKS,12,12,0,413163,100%
1989,MLM-DJ_CASES,9,16,0,413163,100%
1992,MLB-BROTHS,10,7,0,413163,100%
1993,MLB-BICYCLE_SEAT_POSTS,72,95,0,413163,100%
1999,MLM-FISH_FOODS,29,32,0,413163,100%
2008,MLB-SHOCK_MOUNT_INSOLATORS,573,644,0,413163,100%
2018,MLB-WINDOWS,635,1250,0,413163,100%
2024,MLB-PAINTBALL_MARKERS,147,226,0,413163,100%
2028,MLB-CLASSIC_CARS,4323,7238,0,413163,100%
2031,MLB-MOTORCYCLES,10155,17812,0,413163,100%
2045,MLM-LAUNDRY_WASH_BAGS,4,7,0,413163,100%
2046,MLM-HAIRDRESSING_CAPES,16,28,0,413163,100%
2054,MLM-LEARNING_MAZES,9,4,0,413163,100%
2057,MLB-DOG_MUZZLES,50,154,0,413163,100%
2059,MLM-CONTACT_LENS_CLEANING_SOLUTIONS,8,12,0,413163,100%
2060,MLM-BREAD_MAKERS,13,15,0,413163,100%
2062,MLM-VARIABLE_FREQUENCY_DRIVES,7,7,0,413163,100%
2063,MLM-BILL_COUNTERS,6,13,0,413163,100%
2064,MLM-ELECTRIC_GRILLS,18,24,0,413163,100%
2065,MLM-VINEGARS,4,7,0,413163,100%
2066,MLM-TROLLEY_AND_FURNITURE_CASTERS,40,46,0,413163,100%
2067,MLM-SUMP_GUARDS,53,65,0,413163,100%
2069,MLM-HOT_DOG_MACHINES,8,12,0,413163,100%
2070,MLM-HOSE_ADAPTERS,21,27,0,413163,100%
2071,MLM-ESTHETIC_HEADBANDS,15,24,0,413163,100%
2072,MLM-BUGGYS,22,28,0,413163,100%
2073,MLM-TABLE_RUNNERS,12,7,0,413163,100%
2074,MLM-WHEEL_HUBS,53,35,0,413163,100%
2075,MLM-ELECTRIC_DOUGH_SHEETERS,5,1,0,413163,100%
2079,MLM-BICYCLE_CHAIN_CLEANERS,6,7,0,413163,100%
2087,MLB-BIRD_BANDS,60,116,0,413163,100%
2088,MLM-SHOWER_DOORS,39,47,0,413163,100%
2089,MLM-TENNIS_BALLS,28,25,0,413163,100%
2109,MLM-HOME_APPLIANCE_CONTACTORS_AND_RELAYS,34,43,0,413163,100%
2121,MLM-RESPIRATORS,35,32,0,413163,100%
2125,MLM-RABBIT_AND_RODENT_HOUSES,19,26,0,413163,100%
2126,MLM-OTHER_HEAVY_VEHICLES,22,14,0,413163,100%
2129,MLM-AUTOMOTIVE_CLUTCH_FLYWHEELS,5,3,0,413163,100%
2130,MLM-TONER_CHIPS,16,16,0,413163,100%
2131,MLM-DRINK_STIRRERS,6,5,0,413163,100%
2132,MLM-GOLF_CLUBS_WOODS_AND_HYBRIDS,27,43,0,413163,100%
2134,MLM-SOAP_HOLDERS,16,6,0,413163,100%
2135,MLM-MUSICAL_TRIANGLES,1,2,0,413163,100%
2136,MLM-OSCILLOSCOPES,25,37,0,413163,100%
2137,MLM-CARS_AND_VANS_JACK_STANDS,9,18,0,413163,100%
2138,MLM-CAMERA_CASES,59,57,0,413163,100%
2139,MLM-AQUARIUM_FILTER_MATERIALS,3,3,0,413163,100%
2140,MLM-LATEX_ENAMEL_AND_ACRYLIC_PAINTS,14,20,0,413163,100%
2144,MLM-AUTOMOTIVE_BUMPER_BRACKETS,29,26,0,413163,100%
2145,MLM-WALKIE_TALKIE_CHARGERS,33,35,0,413163,100%
2146,MLM-PALLETS,14,24,0,413163,100%
2147,MLM-CYCLING_SHOES,20,18,0,413163,100%
2148,MLM-PEC_DECK_MACHINES,2,0,0,413163,100%
2150,MLM-AUTOMOTIVE_FILTER_KITS,24,25,0,413163,100%
2151,MLM-COMPUTER_USB_LAMPS,23,41,0,413163,100%
2152,MLM-ENGINE_OIL_DIPSTICKS,20,24,0,413163,100%
2153,MLM-ENGINE_INTAKE_MANIFOLDS,14,16,0,413163,100%
2157,MLB-MOTOR_BOATS,641,759,0,413163,100%
2159,MLB-TOOL_NOZZLES,36,56,0,413163,100%
2161,MLM-MOTORCYCLE_METER_CASES,10,14,0,413163,100%
2166,MLM-TILLERS,11,19,0,413163,100%
2169,MLM-SCHOOL_AND_OFFICE_ENVELOPES,14,20,0,413163,100%
2171,MLM-HOME_OFFICE_DESK_ORGANIZERS,31,39,0,413163,100%
2174,MLB-CAR_ROOF_BOXES,172,201,0,413163,100%
2175,MLM-DEVELOPMENT_APARTMENTS_FOR_SALE,22,21,0,413163,100%
2176,MLM-ORAL_REHYDRATION_MEDICINES,9,8,0,413163,100%
2179,MLM-YARNS,60,92,0,413163,100%
2181,MLM-AIR_CONDITIONER_MOTORS,8,17,0,413163,100%
2182,MLM-FLOOR_LAMPS,25,25,0,413163,100%
2183,MLM-DECORATIVE_BASKETS,30,38,0,413163,100%
2184,MLM-DOOR_PULL_AND_PUSH_HANDLES,18,18,0,413163,100%
2186,MLM-BICYCLE_CARGO_RACKS,11,7,0,413163,100%
2187,MLM-MEDICAL_AND_LABORATORY_AUTOCLAVES,3,13,0,413163,100%
2188,MLM-CAR_AIR_FRESHENERS,36,67,0,413163,100%
2190,MLM-TOILET_RUGS,17,44,0,413163,100%
2191,MLM-MEAT_BAND_SAWS,8,6,0,413163,100%
2192,MLM-MOTORCYCLE_OIL_FILTERS,15,27,0,413163,100%
2193,MLM-TABLE_TENNIS_BALLS,7,7,0,413163,100%
2194,MLM-COMPUTER_CLEANING_KITS,4,6,0,413163,100%
2195,MLM-BROOCHES,18,20,0,413163,100%
2196,MLM-CAMERA_CHARGERS,25,35,0,413163,100%
2197,MLM-ANTIQUE_CHANDELIERS,12,11,0,413163,100%
2199,MLM-PAINT_BOOTHS,2,3,0,413163,100%
2200,MLM-TILE_AND_CLADDING_ADHESIVE_MIXTURES,2,2,0,413163,100%
2201,MLM-FAKE_BANGS,13,4,0,413163,100%
2202,MLM-SORTING_AND_STACKING_TOYS,3,3,0,413163,100%
2203,MLM-TEAPOTS,20,22,0,413163,100%
2204,MLB-INDIVIDUAL_HOUSES_FOR_SALE,2854,2989,0,413163,100%
2206,MLM-BICYCLE_HUBS,45,39,0,413163,100%
2207,MLM-CONSTRUCTION_PROFILES,5,6,0,413163,100%
2216,MLB-CAR_HOODS,355,392,0,413163,100%
2226,MLM-CLAW_MACHINES,9,10,0,413163,100%
2227,MLM-SCHOOL_MODELING_CLAYS,24,38,0,413163,100%
2230,MLB-PET_FOOTWEAR,22,51,0,413163,100%
2231,MLM-COMPUTER_KEYBOARD_COVERS,33,77,0,413163,100%
2232,MLM-CHAMPAGNES,14,11,0,413163,100%
2233,MLM-CAR_DOOR_HINGES,21,17,0,413163,100%
2234,MLM-CO2_EFFECTS_MACHINES,2,1,0,413163,100%
2235,MLM-HOUSES_FOR_VACATION_RENTAL,28,18,0,413163,100%
2238,MLM-ERASERS,19,28,0,413163,100%
2239,MLM-MOTORCYCLE_BRAKE_CALIPERS,6,10,0,413163,100%
2240,MLM-CELLPHONE_AND_TABLET_SKINS,49,63,0,413163,100%
2241,MLM-JUICES,36,55,0,413163,100%
2242,MLM-TAPE_DECKS,10,10,0,413163,100%
2243,MLM-TOY_SOLDIERS,23,19,0,413163,100%
2248,MLB-BICYCLE_STEMS,118,135,0,413163,100%
2249,MLM-VIDEO_GAME_CONTROLLER_CHARGERS,13,15,0,413163,100%
2250,MLM-PAINTBALL_REMOTES,4,4,0,413163,100%
2251,MLM-VIDEO_GAME_STEERING_WHEELS,26,14,0,413163,100%
2253,MLM-PANETTONES,1,0,0,413163,100%
2255,MLM-SAFETY_HARNESSES,26,51,0,413163,100%
2256,MLM-CEREALS,44,71,0,413163,100%
2258,MLM-ISOPROPYL_ALCOHOLS,9,15,0,413163,100%
2259,MLM-FRANKLIN_STOVES,8,8,0,413163,100%
2261,MLM-TORQUE_WRENCHES,47,50,0,413163,100%
2263,MLM-RUBBER_FLOORS,11,6,0,413163,100%
2265,MLM-BUTANE_GAS_CARTRIDGES,10,26,0,413163,100%
2266,MLM-SCULPTURED_NAIL_REMOVER_CLIPS,16,29,0,413163,100%
2267,MLM-BICYCLE_BRAKE_LEVERS,6,7,0,413163,100%
2269,MLB-SEX_DOLLS,167,336,0,413163,100%
2274,MLB-TURNBUCKLES,57,68,0,413163,100%
2275,MLM-ENGINE_GASKET_SETS,28,23,0,413163,100%
2277,MLB-CAR_ENGINE_CAMSHAFTS,179,196,0,413163,100%
2278,MLM-BLENDER_DRIVE_COUPLINGS,9,10,0,413163,100%
2279,MLM-ARCHERY_ARROWS,27,26,0,413163,100%
2280,MLM-BICYCLE_TRAILERS,10,8,0,413163,100%
2281,MLM-MOTORCYCLE_KICK_LEVER_PEDALS,6,4,0,413163,100%
2283,MLM-REFRIGERATOR_AND_FREEZER_THERMOSTATS,7,6,0,413163,100%
2285,MLM-BLOCK_MAKING_MACHINES,9,14,0,413163,100%
2286,MLM-SPORT_HEADBANDS,11,27,0,413163,100%
2287,MLM-KITCHEN_MORTARS,17,13,0,413163,100%
2289,MLM-EROTIC_ANAL_AND_VAGINAL_DOUCHES,7,11,0,413163,100%
2290,MLM-NAIL_RHINESTONES,20,31,0,413163,100%
2291,MLM-KITCHEN_TONGS,12,16,0,413163,100%
2293,MLM-WIRELESS_CHARGING_RECEIVERS,25,45,0,413163,100%
2294,MLM-WEIGHT_PLATES,63,101,0,413163,100%
2295,MLM-EXERCISE_MATS,38,52,0,413163,100%
2296,MLM-MOTORCYCLE_FOOT_PEGS,24,28,0,413163,100%
2299,MLM-SNARE_DRUMS,22,21,0,413163,100%
2300,MLB-FISHES,266,378,0,413163,100%
2303,MLM-ELECTRICAL_TIMERS,7,7,0,413163,100%
2304,MLM-KAYAKS,10,10,0,413163,100%
2306,MLM-CAMERA_REMOTE_CONTROLS,14,16,0,413163,100%
2309,MLM-WALL_BRACKETS,6,3,0,413163,100%
2310,MLM-ARCHERY_BOWS,28,31,0,413163,100%
2318,MLB-AUTOMOTIVE_GEARBOX_MOUNT_BRACKETS,133,133,0,413163,100%
2321,MLM-PNEUMATIC_STAPLERS,8,5,0,413163,100%
2324,MLM-ICE_CREAM_SERVING_SPOONS,14,16,0,413163,100%
2325,MLM-KEY_RACKS,31,52,0,413163,100%
2326,MLM-FOOD_CARVING_TOOLS,9,35,0,413163,100%
2327,MLM-OXYGEN_CONCENTRATORS,18,64,0,413163,100%
2329,MLM-INDUSTRIAL_DOUGH_KNEADERS,14,8,0,413163,100%
2330,MLM-BUILDINGS_FOR_SALE,12,2,0,413163,100%
2331,MLM-FISH_TANK_ORNAMENTS,52,52,0,413163,100%
2332,MLM-TV_SMPS,23,14,0,413163,100%
2333,MLM-HAND_FILES,7,11,0,413163,100%
2338,MLB-FUTONS,47,49,0,413163,100%
2342,MLB-MINI_COMPONENT_SYSTEMS,536,1166,0,413163,100%
2353,MLB-BRAKE_BOOSTERS,144,128,0,413163,100%
2364,MLB-AUTOMOTIVE_ENGINES,948,1310,0,413163,100%
2366,MLB-CRASHED_CARS,894,865,0,413163,100%
2370,MLB-KAYAKS,394,872,0,413163,100%
2377,MLM-DENTAL_EQUIPMENT,33,37,0,413163,100%
2380,MLM-SCREEN_SEPARATOR_MACHINES,16,38,0,413163,100%
2381,MLM-GOLF_GLOVES,13,7,0,413163,100%
2382,MLM-BABY_BOTTLE_WARMERS,18,18,0,413163,100%
2384,MLM-ETHYL_ALCOHOL,6,10,0,413163,100%
2385,MLM-LOCKING_PLIERS,19,14,0,413163,100%
2386,MLM-CABLE_ORGANIZERS,14,26,0,413163,100%
2387,MLM-PROMOTIONAL_PRODUCTS,4,4,0,413163,100%
2391,MLB-NUNCHAKUS,43,51,0,413163,100%
2392,MLB-SURFBOARD_LEASHES,28,27,0,413163,100%
2397,MLB-ANTI_THEFT_STUDS,394,457,0,413163,100%
2398,MLB-ENGINE_CONNECTING_RODS,93,81,0,413163,100%
2406,MLB-INDUSTRIAL_COFFEE_MAKERS,31,42,0,413163,100%
2407,MLB-VIDEO_CASSETTES,36,61,0,413163,100%
2409,MLB-FOLDERS_AND_EXPANDING_FILES,336,343,0,413163,100%
2412,MLB-WASHING_MACHINE_ELECTROVALVES,14,15,0,413163,100%
2414,MLM-SECURITY_SEALS,11,12,0,413163,100%
2420,MLM-TOASTERS,18,32,0,413163,100%
2421,MLM-SPRAY_PAINTS,17,17,0,413163,100%
2422,MLM-FISH_TANK_THERMOSTATS,13,12,0,413163,100%
2424,MLM-GAS_DETECTORS,8,14,0,413163,100%
2425,MLM-BABY_CRIB_BUMPERS,2,5,0,413163,100%
2426,MLM-HAIR_CLIPS,5,3,0,413163,100%
2427,MLM-TRIVETS,5,6,0,413163,100%
2428,MLM-VIDEO_GAME_DRUMS,11,6,0,413163,100%
2436,MLM-SCREEN_PRINTING_KITS,2,3,0,413163,100%
2437,MLM-LAWN_MOWER_BLADES,2,1,0,413163,100%
2438,MLM-ROOF_TILES,22,27,0,413163,100%
2439,MLM-TROMBONES,21,34,0,413163,100%
2453,MLB-BICYCLE_WRENCHES,142,185,0,413163,100%
2456,MLB-OTHER_PROPERTIES_FOR_RENT,84,70,0,413163,100%
2458,MLM-COMMERCIAL_KITCHEN_WORK_TABLES,13,14,0,413163,100%
2459,MLM-CLEANING_SPONGES,34,48,0,413163,100%
2460,MLM-AUTOMOTIVE_RADIATOR_HOSES,19,13,0,413163,100%
2461,MLM-BLOWGUNS,10,5,0,413163,100%
2462,MLM-CHISELS,21,34,0,413163,100%
2463,MLM-MOTORCYCLE_CLUTCH_DISCS,34,19,0,413163,100%
2464,MLM-POOL_CHLORINE,10,17,0,413163,100%
2467,MLB-MOTORHOMES,406,1277,0,413163,100%
2477,MLM-CUE_STICKS,41,40,0,413163,100%
2482,MLM-HAIRDRESSING_TRAINING_HEADS,14,10,0,413163,100%
2483,MLM-FENCE_PRIVACY_TAPES,12,22,0,413163,100%
2484,MLM-MOTORCYCLE_CDI_MODULES,20,34,0,413163,100%
2487,MLB-CONSTRUCTION_MACHINERY,438,619,0,413163,100%
2489,MLM-TURNTABLE_NEEDLES,2,1,0,413163,100%
2490,MLM-DRUM_THRONES,6,4,0,413163,100%
2497,MLM-GAS_HEATERS,14,20,0,413163,100%
2503,MLB-CHALKBOARDS_AND_WHITEBOARDS,77,84,0,413163,100%
2513,MLB-BICYCLE_HANDLEBAR_GRIPS,135,213,0,413163,100%
2524,MLB-INDIVIDUAL_APARTMENTS_FOR_SALE,1225,1311,0,413163,100%
2526,MLB-BICYCLE_DISC_BRAKE_ROTORS,40,62,0,413163,100%
2527,MLB-TOOL_ARMATURES,92,98,0,413163,100%
2528,MLM-PLASTIC_INJECTION_MOLDING_MACHINES,2,2,0,413163,100%
2529,MLM-TREKKING_POLES,3,3,0,413163,100%
2530,MLM-WELDING_RODS,20,21,0,413163,100%
2531,MLM-CUTTING_BOARDS,18,26,0,413163,100%
2533,MLM-REFRIGERATOR_WATER_FILTERS,4,6,0,413163,100%
2534,MLM-JEWELRY_MAKING_KITS,4,6,0,413163,100%
2535,MLM-GYM_LIFTING_STRAPS,11,8,0,413163,100%
2536,MLM-DRAWING_COMPASSES,4,5,0,413163,100%
2537,MLM-TOOTHBRUSH_HOLDERS,23,61,0,413163,100%
2538,MLM-BORESCOPES,13,28,0,413163,100%
2540,MLB-MDF_BOARDS,59,184,0,413163,100%
2546,MLB-FARM_HOUSES_FOR_SALE,783,882,0,413163,100%
2547,MLM-IGNITION_CONTROL_MODULES,42,60,0,413163,100%
2549,MLB-CELLPHONE_REPLACEMENT_CAMERAS,105,146,0,413163,100%
2550,MLB-AUTOMOTIVE_AC_CONTROL_PANELS,222,247,0,413163,100%
2554,MLM-VEHICLE_ENGINE_PISTON_RING_SETS,16,18,0,413163,100%
2555,MLM-ALL_TERRAIN_VEHICLE_BOXES,15,22,0,413163,100%
2556,MLM-CAR_AC_CONDENSERS,9,15,0,413163,100%
2557,MLM-MICROBLADING_NEEDLES,40,53,0,413163,100%
2572,MLM-CONVEYOR_BELTS,4,18,0,413163,100%
2573,MLM-PRESSOTHERAPY_MACHINES,3,3,0,413163,100%
2574,MLM-TEXTILE_LABELS,6,10,0,413163,100%
2575,MLM-HOT_TUBS,28,28,0,413163,100%
2576,MLM-MODEL_RAILROADING_ACCESSORIES,4,0,0,413163,100%
2577,MLM-WINDOWS,15,17,0,413163,100%
2578,MLM-SOFT_DRINKS,25,32,0,413163,100%
2580,MLB-PADLOCKS,236,367,0,413163,100%
2581,MLM-DECORATIVE_NO_LIGHT_SIGNS,10,6,0,413163,100%
2582,MLM-DISHWASHERS,11,12,0,413163,100%
2583,MLM-LOAD_MOVING_SKATES,11,9,0,413163,100%
2584,MLM-MOTOR_BOATS,20,22,0,413163,100%
2585,MLM-INDUSTRIAL_DONUT_MAKERS,5,8,0,413163,100%
2586,MLM-USB_WARMERS,9,10,0,413163,100%
2587,MLM-CAKES,5,4,0,413163,100%
2588,MLM-PEDOMETERS,16,23,0,413163,100%
2589,MLM-SUSPENSION_TRAINERS,21,20,0,413163,100%
2590,MLM-ANTI_STATIC_GLOVES,3,1,0,413163,100%
2592,MLM-SEASONINGS,53,29,0,413163,100%
2593,MLM-AUTOMOTIVE_SPEEDOMETERS_AND_TACHOMETERS,53,78,0,413163,100%
2595,MLM-TOOL_BATTERIES,18,25,0,413163,100%
2596,MLM-TRASH_BAGS,8,7,0,413163,100%
2597,MLM-VIOLIN_AND_VIOLA_CHINRESTS,5,0,0,413163,100%
2599,MLM-PET_DRYERS,5,6,0,413163,100%
2600,MLM-POOL_CLEANERS,3,3,0,413163,100%
2601,MLB-CAR_AC_CONDENSERS,145,164,0,413163,100%
2607,MLM-TPS_SENSORS,54,52,0,413163,100%
2610,MLM-AUTOMOTIVE_DOOR_PANELS,45,69,0,413163,100%
2611,MLM-GUITAR_STRAPS,18,20,0,413163,100%
2613,MLM-AUTOMOTIVE_CV_JOINT_BOOTS,30,19,0,413163,100%
2614,MLM-FISH_TANK_PLANTS,14,28,0,413163,100%
2615,MLM-SPICE_RACKS,34,31,0,413163,100%
2617,MLM-BRA_EXTENDERS,2,4,0,413163,100%
2619,MLB-REFRIGERANT_GASES,108,173,0,413163,100%
2621,MLB-AUTOMOTIVE_TIMING_BELT_TENSIONER_PULLEYS,210,239,0,413163,100%
2622,MLB-BUSES,1286,2063,0,413163,100%
2625,MLB-AUTOMOTIVE_POLY_V_BELTS,465,517,0,413163,100%
2631,MLM-BUTTSTOCKS,19,28,0,413163,100%
2632,MLM-AUDIO_AND_VIDEO_OPTICAL_LASER_LENSES,7,16,0,413163,100%
2635,MLB-MEDAL_HANGERS,48,101,0,413163,100%
2636,MLB-MOTORCYCLE_ENGINE_ROCKER_ARMS,30,40,0,413163,100%
2638,MLB-MAGNETIC_AQUARIUM_CLEANERS,51,72,0,413163,100%
2640,MLB-WORKOUT_BENCHES,119,312,0,413163,100%
2642,MLB-LIVING_ROOM_SETS,245,689,0,413163,100%
2646,MLM-CELLPHONE_REPLACEMENT_KEYBOARDS,7,12,0,413163,100%
2651,MLB-BICYCLE_ELECTRIC_ENGINE_KITS,7,15,0,413163,100%
2657,MLB-SAFETY_HELMETS,35,20,0,413163,100%
2658,MLB-EMBROIDERY_MACHINES,114,187,0,413163,100%
2662,MLB-ROLLING_SHOPPING_CARTS,60,94,0,413163,100%
2667,MLB-FIREFIGHTER_UNIFORMS,14,15,0,413163,100%
2677,MLB-ORGANIZER_CABINETS_AND_BOXES,158,312,0,413163,100%
2679,MLM-CAR_RACE_TRACKS_AND_BLAST_LAUNCHERS,31,31,0,413163,100%
2687,MLM-BATH_TOYS,6,5,0,413163,100%
2688,MLM-ELECTRIC_SHEARS,9,16,0,413163,100%
2694,MLB-PROJECTOR_SCREENS,199,343,0,413163,100%
2695,MLM-CELLPHONE_REPLACEMENT_SPEAKERS,26,19,0,413163,100%
2696,MLM-COLLECTIBLE_POSTAL_ENVELOPES,1,1,0,413163,100%
2697,MLM-BACK_SCRATCHERS,2,2,0,413163,100%
2698,MLM-MAKEUP_BRUSH_TEXTURED_CLEANERS,21,53,0,413163,100%
2699,MLM-AMERICAN_FOOTBALL_HELMETS,23,22,0,413163,100%
2704,MLM-QUICK_COUPLERS,10,11,0,413163,100%
2705,MLM-SPORT_PROTECTIVE_GEAR_SETS,19,28,0,413163,100%
2707,MLM-BABY_STROLLER_MOSQUITO_COVERS,7,21,0,413163,100%
2716,MLB-ANTIQUE_TELEPHONES,44,78,0,413163,100%
2726,MLB-NGV_FULL_EQUIPMENTS,100,206,0,413163,100%
2729,MLB-SURFBOARDS,134,175,0,413163,100%
2733,MLB-AC_COMPRESSOR_CLUTCH_COILS,73,60,0,413163,100%
2736,MLB-LATEX_ENAMEL_AND_ACRYLIC_PAINTS,138,289,0,413163,100%
2738,MLM-SCREW_EXTRACTORS,4,3,0,413163,100%
2740,MLM-TUBAS,11,16,0,413163,100%
2744,MLM-GLAZED_DISPLAY_CABINETS,39,41,0,413163,100%
2745,MLB-DECORATIVE_ANIMAL_HEADS,34,47,0,413163,100%
2747,MLB-BICYCLE_CHAINRINGS,85,117,0,413163,100%
2751,MLB-OPTICAL_INSTRUMENT_EYEPIECES,12,13,0,413163,100%
2756,MLB-APARTMENTS_FOR_RENT,630,679,0,413163,100%
2757,MLM-FISH_TANK_WAVE_MAKERS,7,3,0,413163,100%
2758,MLM-PNEUMATIC_DOOR_CLOSERS,21,27,0,413163,100%
2760,MLM-BABY_BATHTUB_SEATS,2,3,0,413163,100%
2761,MLM-KITCHEN_BATTER_DISPENSERS,11,18,0,413163,100%
2762,MLM-DOG_FRISBEES,4,1,0,413163,100%
2763,MLM-CARABINERS,29,37,0,413163,100%
2764,MLM-BABY_BEDROOM_SETS,2,0,0,413163,100%
2765,MLM-ANEMOMETERS,1,1,0,413163,100%
2766,MLM-CHURRO_MAKING_MACHINES,21,16,0,413163,100%
2767,MLM-NEOPRENE_SOCKS,1,1,0,413163,100%
2768,MLM-BOATS,13,17,0,413163,100%
2773,MLM-BABY_CHANGING_PADS,12,7,0,413163,100%
2779,MLB-RACQUETS,98,103,0,413163,100%
2781,MLB-PROTECTIVE_ADHESIVE_BANDAGES,17,10,0,413163,100%
2787,MLM-DRONE_BATTERIES,15,22,0,413163,100%
2789,MLB-HOME_AND_OFFICE_FOOTRESTS,20,20,0,413163,100%
2794,MLB-CORDLESS_TELEPHONE_BATTERIES,53,42,0,413163,100%
2797,MLB-AUTOMOTIVE_SUNROOFS,48,76,0,413163,100%
2800,MLB-AUTOMOTIVE_DOOR_PANELS,479,612,0,413163,100%
2801,MLM-CAR_DISTRIBUTORS,53,52,0,413163,100%
2802,MLB-CRAFT_GLITTER,10,13,0,413163,100%
2808,MLM-PORCELAIN_TILES,11,17,0,413163,100%
2810,MLM-SAFETY_FACE_SHIELD_VISORS,10,12,0,413163,100%
2811,MLB-GARAGE_DOORS,169,277,0,413163,100%
2812,MLB-STEEL_WIRE_MESHES,280,530,0,413163,100%
2817,MLM-BUBBLE_LEVELS,12,17,0,413163,100%
2820,MLM-NUNCHAKUS,9,34,0,413163,100%
2821,MLM-XYLOPHONES_AND_METALLOPHONES,2,3,0,413163,100%
2822,MLM-PRINTER_FUSERS,33,32,0,413163,100%
2823,MLM-COMPRESSED_AIR_DUSTERS,8,11,0,413163,100%
2831,MLM-TABLE_FRUIT_BOWLS,15,13,0,413163,100%
2836,MLB-CATS_LITTER,75,96,0,413163,100%
2837,MLB-TURNTABLES,117,195,0,413163,100%
2843,MLB-INDUSTRIAL_COOKING_OVENS,464,934,0,413163,100%
2848,MLM-CAR_INTERCOOLERS,1,1,0,413163,100%
2850,MLM-HOUSE_FENCES,19,28,0,413163,100%
2852,MLM-PAPER_NAPKINS,9,16,0,413163,100%
2856,MLM-AUTOMOBILE_DOOR_GLASSES,22,23,0,413163,100%
2861,MLM-BABY_DIAPERS,13,19,0,413163,100%
2862,MLM-FARMS_FOR_SALE,10,7,0,413163,100%
2863,MLM-OUTDOOR_BLINDS,18,0,0,413163,100%
2866,MLM-TOY_KEYBOARDS_AND_PIANOS,9,11,0,413163,100%
2867,MLM-SCANNERS,21,28,0,413163,100%
2872,MLB-DISC_BRAKE_PADS_WEAR_SENSORS,44,51,0,413163,100%
2881,MLB-SWAY_BAR_LINKS,294,312,0,413163,100%
2882,MLB-FABRIC_CUTTING_MACHINES,37,64,0,413163,100%
2889,MLB-COLLECTIBLE_BILLS,180,200,0,413163,100%
2892,MLB-PLANT_POTS_AND_PLANTERS,144,132,0,413163,100%
2898,MLB-AUTOMOTIVE_BLOWER_HEATER_MOTORS,13,5,0,413163,100%
2899,MLB-HABERDASHERY_FABRIC_FLOWERS,16,6,0,413163,100%
2907,MLB-TOY_VIRTUAL_PETS,60,97,0,413163,100%
2909,MLM-EROTIC_PUMPS,26,64,0,413163,100%
2913,MLM-ESOTERIC_PENDULUMS,4,1,0,413163,100%
2914,MLM-GREENHOUSES,11,12,0,413163,100%
2915,MLM-AUTOMOTIVE_AIR_INTAKE_SNORKELS,12,6,0,413163,100%
2916,MLM-SLINGSHOTS,21,23,0,413163,100%
2917,MLM-ESPADRILLES,41,73,0,413163,100%
2919,MLB-AUTOMOTIVE_FUEL_TANKS,161,177,0,413163,100%
2920,MLB-DISHWASHERS,154,250,0,413163,100%
2921,MLM-AUTOMOTIVE_TOW_HOOKS,10,13,0,413163,100%
2922,MLM-THERMAL_CAN_AND_BOTTLE_HOLDERS,12,18,0,413163,100%
2923,MLM-CONSTRUCTION_PUTTIES_AND_SPACKELS,1,1,0,413163,100%
2925,MLM-LAPTOP_REPLACEMENT_INTERNAL_SPEAKERS,15,16,0,413163,100%
2926,MLM-BICYCLE_HANDLEBARS,32,36,0,413163,100%
2927,MLM-MICRONEEDLE_ROLLERS,7,13,0,413163,100%
2929,MLB-ROOF_PANELS,201,403,0,413163,100%
2935,MLM-CAR_DISTRIBUTOR_CAPS,9,9,0,413163,100%
2936,MLM-TURNTABLES,24,26,0,413163,100%
2937,MLM-TABLETOP_FOUNTAINS,15,16,0,413163,100%
2938,MLM-MEDICAL_STOOLS,14,20,0,413163,100%
2940,MLM-ALUMINUM_FOILS,5,11,0,413163,100%
2941,MLM-DESKTOP_COMPUTER_EXPANSION_CARDS,24,28,0,413163,100%
2943,MLM-CAMERA_CLEANING_KITS,8,5,0,413163,100%
2944,MLM-FACIAL_TOWELS,11,8,0,413163,100%
2945,MLM-GROOMING_TABLES,1,1,0,413163,100%
2946,MLM-INSTRUMENT_KNOBS,9,8,0,413163,100%
2947,MLM-BATH_SALTS,6,5,0,413163,100%
2948,MLM-FOOD_CARTS,20,25,0,413163,100%
2952,MLM-INTERCOOLER_HOSES,3,3,0,413163,100%
2953,MLM-AUTOMOTIVE_AUDIO_CAPACITORS,31,34,0,413163,100%
2954,MLM-BICYCLE_MULTIFUNCTION_TOOLS,6,6,0,413163,100%
2958,MLB-HARD_AND_SOFT_CHEESES,189,219,0,413163,100%
2959,MLB-BASS_GUITARS,613,641,0,413163,100%
2962,MLM-STUDIO_MONITORS,36,88,0,413163,100%
2963,MLM-REFRIGERATOR_AND_FREEZER_COMPRESSORS,5,2,0,413163,100%
2964,MLM-SATELLITE_FINDERS,5,4,0,413163,100%
2965,MLM-LIFE_JACKETS,27,22,0,413163,100%
2966,MLM-PDA_CHARGERS,1,2,0,413163,100%
2967,MLM-WASHING_MACHINE_DRAIN_PUMPS,4,3,0,413163,100%
2968,MLM-ELECTRONIC_AND_ELECTRICAL_CONTACT_CLEANERS,6,16,0,413163,100%
2970,MLM-MODELISM_BATTERIES,14,15,0,413163,100%
2971,MLM-WRISTWATCH_BUCKLES,4,6,0,413163,100%
2974,MLM-CARBURETOR_CHOKE_CABLES,5,6,0,413163,100%
2977,MLM-RADIO_BASE_STATIONS,10,14,0,413163,100%
2986,MLM-STEEL_WIRE_MESHES,33,57,0,413163,100%
2987,MLM-MOTORCYCLE_ENGINE_GASKET_SETS,14,13,0,413163,100%
2988,MLM-MANUAL_MENSTRUAL_CUP_STERILIZERS,26,120,0,413163,100%
2989,MLM-BASKETBALL_KITS,16,20,0,413163,100%
2990,MLB-WHEELS_BEARINGS,501,499,0,413163,100%
2992,MLB-MEDICAL_STOOLS,26,45,0,413163,100%
2993,MLM-PORTABLE_GAME_CONSOLE_CASES,5,4,0,413163,100%
2994,MLM-PLASTIC_MODEL_KITS,31,35,0,413163,100%
2995,MLB-MOTORCYCLE_HANDLEBAR_CLAMPS,69,85,0,413163,100%
2996,MLB-PAINTBALL_O_RINGS,35,71,0,413163,100%
2997,MLM-INDOOR_GROWING_LIGHTS,14,23,0,413163,100%
3000,MLB-GROOMING_TABLES,33,52,0,413163,100%
3006,MLM-POWER_STEERING_FLUID_RESERVOIRS,17,24,0,413163,100%
3007,MLM-BOXING_HEADGEARS,23,22,0,413163,100%
3009,MLM-BAKING_MATS,21,32,0,413163,100%
3010,MLM-BODY_FAT_CALIPERS,2,2,0,413163,100%
3011,MLM-OCARINAS,12,3,0,413163,100%
3012,MLM-BICYCLE_HANDLEBAR_TAPES,10,24,0,413163,100%
3013,MLM-TOILET_PAPER_HOLDERS,8,10,0,413163,100%
3021,MLB-GARDENING_IRRIGATION_GUNS,29,46,0,413163,100%
3022,MLB-LAPTOP_HOUSINGS,702,738,0,413163,100%
3024,MLB-VIDEO_GAME_STEERING_WHEELS,61,102,0,413163,100%
3029,MLB-RUM,31,39,0,413163,100%
3032,MLB-AUTOMOTIVE_TRANSMISSION_GEARS,201,219,0,413163,100%
3036,MLM-COMMERCIAL_POPCORN_MACHINES,6,7,0,413163,100%
3038,MLM-CAJONS,6,3,0,413163,100%
3040,MLM-MEDAL_HANGERS,19,6,0,413163,100%
3041,MLM-TATTOO_INKS,3,1,0,413163,100%
3042,MLM-SIDE_TABLES,22,27,0,413163,100%
3043,MLM-PET_TOOTHPASTES,11,10,0,413163,100%
3044,MLM-CPR_TRAINING_MANIKINS,6,8,0,413163,100%
3045,MLM-LAPTOP_LOCKS,7,7,0,413163,100%
3050,MLB-BABY_BEDROOM_SETS,212,422,0,413163,100%
3054,MLB-ANVILS,20,63,0,413163,100%
3058,MLB-PORCELAIN_TILES,225,610,0,413163,100%
3060,MLB-FUEL_LEVEL_FLOATS,450,480,0,413163,100%
3062,MLB-BICYCLE_FRONT_DERAILLEURS,34,48,0,413163,100%
3066,MLB-VEHICLE_SEALS,260,240,0,413163,100%
3069,MLM-MOTORCYCLE_EXHAUSTS,18,40,0,413163,100%
3070,MLM-BOMBOS,4,5,0,413163,100%
3074,MLB-VARIABLE_FREQUENCY_DRIVES,474,724,0,413163,100%
3078,MLB-BDSM_KITS,49,76,0,413163,100%
3079,MLB-OVERHEAD_CRANES,13,1,0,413163,100%
3081,MLM-POTENTIOMETERS,11,17,0,413163,100%
3083,MLM-DIRECT_BOXES,2,2,0,413163,100%
3084,MLM-MANUAL_CAPSULE_FILLERS,5,6,0,413163,100%
3085,MLM-TOWEL_SETS,6,16,0,413163,100%
3088,MLM-FABRIC_SOFTENERS,7,1,0,413163,100%
3089,MLM-BABY_BOTTLE_BRUSHES,2,1,0,413163,100%
3091,MLM-RIVETS,7,7,0,413163,100%
3092,MLM-BABY_BOTTLE_DRYING_RACKS,14,5,0,413163,100%
3094,MLB-TRAILER_HITCHES,175,236,0,413163,100%
3095,MLB-HIKING_BOOTS,30,32,0,413163,100%
3099,MLM-AUTOMOTIVE_CLIPS,10,12,0,413163,100%
3100,MLM-AUTOMOTIVE_MIRROR_COVERS,13,17,0,413163,100%
3101,MLM-BARBED_WIRES,7,7,0,413163,100%
3102,MLB-SIM_CARD_ADAPTERS,21,26,0,413163,100%
3106,MLM-BRANDIES,14,18,0,413163,100%
3109,MLM-BEER_DISPENSERS,16,26,0,413163,100%
3113,MLM-AUTOMOTIVE_SHOCK_ABSORBERS_AIR_BAGS,17,34,0,413163,100%
3116,MLM-TYPEWRITERS,8,0,0,413163,100%
3117,MLM-WINTER_EARMUFFS,9,7,0,413163,100%
3121,MLM-RIVET_GUNS,15,23,0,413163,100%
3122,MLM-BICYCLE_SPRING_SUSPENSIONS,1,0,0,413163,100%
3123,MLM-TOOL_BAGS_AND_BACKPACKS,28,51,0,413163,100%
3126,MLB-GOJI_BERRIES,11,15,0,413163,100%
3128,MLM-PERCUSSION_MARACAS,6,6,0,413163,100%
3129,MLM-TORTILLA_PRESSES,13,14,0,413163,100%
3132,MLB-HAZELNUT_CREAMS,39,28,0,413163,100%
3136,MLM-DOG_BACKPACKS_AND_SADDLEBAGS,15,41,0,413163,100%
3137,MLM-SALAD_SPINNERS,9,10,0,413163,100%
3138,MLM-C_CLAMPS,1,1,0,413163,100%
3139,MLM-FLATWARE_ORGANIZERS,5,4,0,413163,100%
3142,MLM-HYDRAULIC_CRIMPING_PLIERS,8,6,0,413163,100%
3143,MLM-SALTY_SNACKS,34,43,0,413163,100%
3144,MLM-DANCE_SNEAKERS_AND_SHOES,6,8,0,413163,100%
3145,MLM-KITCHEN_SINK_CADDY_ORGANIZERS,40,82,0,413163,100%
3146,MLM-VODKAS,18,37,0,413163,100%
3147,MLM-SHAWARMA_MACHINES,11,16,0,413163,100%
3148,MLB-BUMPER_IMPACT_ABSORBERS,343,391,0,413163,100%
3153,MLB-CONCERT_TICKETS,247,381,0,413163,100%
3158,MLB-HOUSES_FOR_RENT,1300,1284,0,413163,100%
3161,MLB-SHOWER_DOORS,178,626,0,413163,100%
3164,MLM-AUTOMOTIVE_CLUTCH_MASTER_CYLINDERS,14,17,0,413163,100%
3165,MLB-ELECTRIC_GUITARS,317,404,0,413163,100%
3167,MLM-PROXIMITY_KEY_FOBS,3,4,0,413163,100%
3168,MLM-DRIVING_SIMULATORS,17,15,0,413163,100%
3169,MLM-AUTOMOTIVE_ASHTRAYS,18,29,0,413163,100%
3170,MLM-SUITCASE_COVERS,5,14,0,413163,100%
3171,MLM-INTERNAL_LAPTOP_COOLING_FANS,44,40,0,413163,100%
3172,MLM-PLANT_POT_STANDS,12,18,0,413163,100%
3174,MLM-CLIMBING_ROPES,22,53,0,413163,100%
3175,MLM-AUTOMOTIVE_TRUNK_LIDS,30,32,0,413163,100%
3176,MLM-KITCHEN_FUNNELS,3,6,0,413163,100%
3177,MLM-NAIL_STAMPS,10,8,0,413163,100%
3179,MLB-POSTERS,431,443,0,413163,100%
3182,MLB-RIDING_CROPS,33,29,0,413163,100%
3184,MLM-ELECTRICITY_METERS,20,22,0,413163,100%
3185,MLM-PROJECTOR_CHIPS,3,5,0,413163,100%
3187,MLB-SAFETY_FACE_SHIELD_VISORS,5,11,0,413163,100%
3188,MLB-TABLE_TENNIS_RACKETS,225,445,0,413163,100%
3191,MLB-WAGONS,515,696,0,413163,100%
3192,MLB-MINI_PCS,251,386,0,413163,100%
3200,MLM-ENGINE_BLOCKS,2,3,0,413163,100%
3201,MLM-LICE_COMBS,7,7,0,413163,100%
3216,MLB-CHESTS,86,135,0,413163,100%
3218,MLM-SHEET_PROTECTORS,20,17,0,413163,100%
3219,MLM-CATHETERS,5,9,0,413163,100%
3220,MLM-STOLES,1,1,0,413163,100%
3221,MLM-COFFEE_CAPSULES,37,35,0,413163,100%
3222,MLM-VEHICLE_ELECTRIC_WINCHES,12,19,0,413163,100%
3223,MLM-PLASTIC_WRAPS,7,3,0,413163,100%
3224,MLM-OATMEAL,12,11,0,413163,100%
3225,MLM-PET_BOWS,4,3,0,413163,100%
3226,MLM-TV_REPLACEMENT_LAMPS,2,7,0,413163,100%
3228,MLB-AUTOMOTIVE_FUEL_TANK_DOORS,187,224,0,413163,100%
3230,MLM-MOLEX_CABLES,7,10,0,413163,100%
3231,MLM-BICYCLE_MIRRORS,7,12,0,413163,100%
3232,MLM-CHIP_AND_DIP_SERVERS,14,17,0,413163,100%
3235,MLM-GARDENING_AND_AGRICULTURE_FABRICS_AND_PROTECTIVE_PLASTICS,12,21,0,413163,100%
3236,MLM-COLD_FOOD_AND_DRINK_VENDING_MACHINES,11,11,0,413163,100%
3237,MLM-MOTORCYCLE_SUITS,25,26,0,413163,100%
3238,MLM-SHEET_FOLDING_MACHINES,12,11,0,413163,100%
3239,MLM-SAFETY_CONES,5,5,0,413163,100%
3241,MLM-PATCH_PANELS,4,4,0,413163,100%
3242,MLM-DOLL_CRIBS,2,2,0,413163,100%
3243,MLM-BRAKE_BOOSTERS,14,11,0,413163,100%
3245,MLB-SURFACES_PROTECTIVE_PAINTS,116,221,0,413163,100%
3249,MLB-PEACOCKS,38,61,0,413163,100%
3250,MLM-LINEMAN_PLIERS,27,63,0,413163,100%
3251,MLM-MOTORCYCLE_TRANSMISSION_CROWNS,22,34,0,413163,100%
3254,MLB-OTHER_HEAVY_VEHICLES,58,63,0,413163,100%
3257,MLM-GARDEN_SHEDS,23,38,0,413163,100%
3258,MLM-GYMNASTIC_HAND_GRIPS,20,20,0,413163,100%
3259,MLM-TOY_IRONING_BOARDS,2,1,0,413163,100%
3261,MLM-CALL_BLOCKERS,2,0,0,413163,100%
3262,MLM-DRIVE_SHAFTS,13,12,0,413163,100%
3263,MLM-CERVICAL_COLLARS,16,8,0,413163,100%
3264,MLM-MOTORCYCLE_FORK_TUBES,23,37,0,413163,100%
3274,MLB-INTAKE_MANIFOLD_GASKET_SETS,23,20,0,413163,100%
3276,MLB-CAR_AC_EVAPORATOR_CORES,69,70,0,413163,100%
3280,MLM-PRINTER_RIBBONS,20,20,0,413163,100%
3281,MLM-PICKGUARDS,5,3,0,413163,100%
3282,MLM-LIQUID_DOG_AND_CAT_REPELLENTS,11,29,0,413163,100%
3284,MLM-CROWBARS,5,8,0,413163,100%
3287,MLM-BASEBALL_AND_SOFTBALL_HELMETS,21,8,0,413163,100%
3289,MLM-OIL_AND_VINEGAR_BOTTLES,4,4,0,413163,100%
3292,MLM-SEWING_MACHINE_PRESSER_FEET,15,34,0,413163,100%
3294,MLM-HIP_SCARVES,6,12,0,413163,100%
3295,MLB-ENGINE_PISTONS,561,578,0,413163,100%
3296,MLB-KITCHEN_DEGREASERS,2,1,0,413163,100%
3299,MLB-ROOSTERS_AND_HENS,126,201,0,413163,100%
3307,MLM-CO2_TANKS,3,5,0,413163,100%
3308,MLM-BEARING_PULLERS,11,12,0,413163,100%
3309,MLM-MAGAZINE_HOLDERS,8,16,0,413163,100%
3310,MLM-DRAGGING_TOYS,8,7,0,413163,100%
3311,MLM-CHIPPER_SHREDDERS,11,10,0,413163,100%
3313,MLM-CYCLING_GLOVES_AND_MITTENS,11,23,0,413163,100%
3314,MLM-WATER_SOFTENERS,5,1,0,413163,100%
3315,MLM-TATTOO_MACHINE_POWER_SUPPLIES,2,0,0,413163,100%
3316,MLM-AIR_CURTAINS,3,0,0,413163,100%
3317,MLM-CV_JOINTS,34,40,0,413163,100%
3318,MLM-MOTORCYCLE_CRANKSHAFTS,7,2,0,413163,100%
3319,MLM-TAMBOURINES,9,15,0,413163,100%
3320,MLM-MOULDINGS,7,3,0,413163,100%
3321,MLM-MOTORCYCLE_FOOT_PEG_BRACKETS,6,7,0,413163,100%
3322,MLM-RODENT_SHAMPOOS,8,8,0,413163,100%
3324,MLM-DRYWALLS,12,9,0,413163,100%
3325,MLM-DEEP_FRY_BASKETS,3,7,0,413163,100%
3326,MLM-CONSTRUCTION_SAND,3,2,0,413163,100%
3327,MLM-POPCORN_BOXES,8,6,0,413163,100%
3328,MLM-COMPUTER_VACUUM_CLEANERS,3,5,0,413163,100%
3333,MLB-GLOW_PLUGS,22,14,0,413163,100%
3335,MLM-ANVILS,11,26,0,413163,100%
3337,MLB-AUTOMODELISM_VEHICLES,390,422,0,413163,100%
3339,MLM-CLIMBING_HARNESSES,13,16,0,413163,100%
3340,MLB-AUTOMOTIVE_CV_JOINT_BOOTS,139,134,0,413163,100%
3341,MLB-ROLLER_SKATE_BAGS,13,9,0,413163,100%
3343,MLB-DJ_TURNTABLES,78,93,0,413163,100%
3345,MLM-KITCHEN_CABINET_ORGANIZERS,2,0,0,413163,100%
3346,MLM-NEMA_ENCLOSURES,25,21,0,413163,100%
3349,MLB-CLOTHING_PATCHES,205,283,0,413163,100%
3351,MLB-ROLLING_PINS,77,136,0,413163,100%
3352,MLM-PET_FOOD_STORAGE_CONTAINERS,14,12,0,413163,100%
3354,MLB-DRUMS,444,698,0,413163,100%
3358,MLM-MECHANICAL_PENCILS,7,9,0,413163,100%
3363,MLM-COLLECTIBLE_ALBUM_STICKERS,30,38,0,413163,100%
3364,MLM-EDIBLE_SEAWEEDS,2,3,0,413163,100%
3365,MLM-CONGAS,17,18,0,413163,100%
3366,MLM-WORLD_GLOBES,4,3,0,413163,100%
3367,MLM-CONCRETE_BLOCKS,6,7,0,413163,100%
3368,MLB-PHOTOCOPIERS,33,42,0,413163,100%
3371,MLB-TEXTURE_COATINGS,12,20,0,413163,100%
3372,MLB-WIRELESS_ANTENNAS,324,429,0,413163,100%
3373,MLB-MOTORCYCLE_GASOLINE_TANKS,289,362,0,413163,100%
3374,MLM-FRAME_POOLS,23,34,0,413163,100%
3377,MLM-STAMP_PUNCHES,5,5,0,413163,100%
3378,MLB-HOME_SHELVES,367,602,0,413163,100%
3380,MLB-CLAW_MACHINES,23,23,0,413163,100%
3382,MLB-BICYCLE_BRAKE_LEVERS,47,51,0,413163,100%
3384,MLB-COLLECTIBLE_PHONE_CARDS,33,67,0,413163,100%
3387,MLB-AIRBAG_MODULES,28,29,0,413163,100%
3390,MLM-BICYCLE_PEDALS,27,45,0,413163,100%
3394,MLM-POOL_CHEMICAL_TEST_KITS,1,2,0,413163,100%
3395,MLM-PRINTER_HEADS,23,35,0,413163,100%
3396,MLM-DJ_EFFECTS_PROCESSORS,10,17,0,413163,100%
3397,MLM-SHRINK_TUNNELS,2,2,0,413163,100%
3398,MLM-KITCHEN_CHEESE_SLICERS,1,1,0,413163,100%
3399,MLM-THICKNESS_GAUGES,5,7,0,413163,100%
3404,MLM-KITCHEN_TIMERS,2,2,0,413163,100%
3407,MLB-PANETTONES,34,39,0,413163,100%
3412,MLB-TOY_PLANES,93,182,0,413163,100%
3416,MLB-BRAKE_LIGHTS,171,188,0,413163,100%
3419,MLB-BICYCLE_SPOKES,12,7,0,413163,100%
3429,MLM-EROTIC_ROBES,2,2,0,413163,100%
3430,MLM-TATTOO_NEEDLE_CARTRIDGES,1,1,0,413163,100%
3431,MLM-OFFICE_STORAGE_CABINETS,11,11,0,413163,100%
3434,MLM-STONE_FLOORINGS,18,27,0,413163,100%
3435,MLM-SANDBLASTERS,7,10,0,413163,100%
3436,MLM-MICROBLADING_RULERS,8,3,0,413163,100%
3437,MLM-COLLECTION_DISPLAYS,8,11,0,413163,100%
3438,MLM-HYDRATION_BLADDERS,5,2,0,413163,100%
3439,MLM-CLUTCH_FORKS,4,3,0,413163,100%
3440,MLM-BATHROOM_HOOKS,4,7,0,413163,100%
3441,MLM-FIBER_OPTIC_FAULT_LOCATORS,5,4,0,413163,100%
3442,MLM-AUTOMOTIVE_IGNITION_CYLINDERS,15,27,0,413163,100%
3443,MLM-BASEBALL_AND_SOFTBALL_PANTS,11,14,0,413163,100%
3444,MLM-DOLL_STROLLERS,27,42,0,413163,100%
3450,MLB-CONSTRUCTION_FINISHING_TROWELS,116,203,0,413163,100%
3451,MLM-PAINTBALL_MARKER_MAGAZINES,16,33,0,413163,100%
3456,MLB-HELIUM_TANKS,22,36,0,413163,100%
3459,MLB-AUTOMOTIVE_SPEEDOMETERS_AND_TACHOMETERS,374,528,0,413163,100%
3460,MLB-WINE_ACCESSORY_SETS,115,245,0,413163,100%
3462,MLM-AUTOMOTIVE_WATER_PUMP_PULLEYS,5,3,0,413163,100%
3464,MLM-GLASSES_CASES_AND_BAGS,11,10,0,413163,100%
3465,MLM-FOOD_AND_DRINK_SYRUPS,10,22,0,413163,100%
3467,MLM-WASHING_MACHINE_HOSES,12,12,0,413163,100%
3468,MLM-AMBULANCES,13,16,0,413163,100%
3469,MLM-DONUT_MAKERS,5,1,0,413163,100%
3472,MLM-PHOTOCOPIER_RUBBERS,1,1,0,413163,100%
3473,MLM-AUTOMOTIVE_BRAKE_KITS,12,13,0,413163,100%
3475,MLB-ESTHETIC_HEADBANDS,18,40,0,413163,100%
3480,MLM-CAR_EXHAUSTS,1,0,0,413163,100%
3481,MLM-OIL_PAINTS,11,26,0,413163,100%
3482,MLM-STATUES,55,97,0,413163,100%
3484,MLM-DECORATIVE_VASES,10,11,0,413163,100%
3485,MLM-SHOE_REPLACEMENT_CLEATS,8,13,0,413163,100%
3486,MLM-VEHICLE_SEALS,9,11,0,413163,100%
3487,MLB-AUTOMOTIVE_ENGINE_FANS,277,311,0,413163,100%
3488,MLB-REFRIGERATOR_AND_FREEZER_HINGES,44,45,0,413163,100%
3491,MLM-FOLDING_CAMPING_TABLES_AND_CHAIRS_SETS,3,3,0,413163,100%
3492,MLM-DENTAL_PORCELAIN_OVENS,2,2,0,413163,100%
3494,MLB-BICYCLE_HUBS,119,132,0,413163,100%
3495,MLB-MAF_SENSORS,121,198,0,413163,100%
3496,MLB-DOG_HOUSES,173,407,0,413163,100%
3500,MLM-POOL_FILTERS,7,7,0,413163,100%
3501,MLM-VIDEOCASSETTE_PLAYERS,3,5,0,413163,100%
3504,MLM-SHAPER_AND_MILLING_MACHINES,17,11,0,413163,100%
3505,MLM-TACTICAL_POUCHES,22,30,0,413163,100%
3508,MLM-WINDSHIELD_WIPER_SWITCHES,10,8,0,413163,100%
3509,MLM-EGG_SLICERS,2,0,0,413163,100%
3511,MLM-FOOD_AND_DRINK_EXTRACTS,9,8,0,413163,100%
3512,MLM-AUTOMOTIVE_REAR_AXLES,3,2,0,413163,100%
3513,MLM-SCREEN_CLEANERS,3,5,0,413163,100%
3519,MLM-KITCHEN_NUTCRACKERS,9,13,0,413163,100%
3521,MLM-CABLE_COVERS,4,4,0,413163,100%
3522,MLM-PARTY_FAVOR_RINGS,2,4,0,413163,100%
3523,MLM-CHURRO_AND_COOKIE_PRESS_GUNS,3,2,0,413163,100%
3525,MLM-TOY_ICE_CREAM_MACHINES,5,7,0,413163,100%
3526,MLM-GATE_WHEELS,6,2,0,413163,100%
3530,MLB-RETAIL_SPACE_FOR_SALE,129,214,0,413163,100%
3531,MLB-WORK_SCRUBS,71,101,0,413163,100%
3533,MLM-CUPCAKES_MAKERS,9,11,0,413163,100%
3534,MLM-BRAKE_LIGHT_SWITCHES,12,18,0,413163,100%
3535,MLB-ENGINE_COOLING_FAN_SHROUDS,78,58,0,413163,100%
3536,MLM-TOILET_SEATS,24,28,0,413163,100%
3540,MLB-INTERCOOLER_HOSES,119,153,0,413163,100%
3543,MLB-HORSE_CARE_TOOL_KITS,24,30,0,413163,100%
3544,MLB-MOTORCYCLE_FOOT_PEGS,64,89,0,413163,100%
3547,MLB-CAR_SPOILERS,522,786,0,413163,100%
3550,MLB-MOTORCYCLE_FORK_TUBES,188,223,0,413163,100%
3558,MLB-AQUARIUM_CO2_REGULATORS,22,25,0,413163,100%
3562,MLB-BILLIARD_BALLS,17,17,0,413163,100%
3563,MLB-PLIER_SETS,65,141,0,413163,100%
3564,MLB-EMBROIDERY_DESIGNS,153,129,0,413163,100%
3565,MLM-TAROT_CARDS,12,15,0,413163,100%
3566,MLM-RODENT_FOODS,2,1,0,413163,100%
3567,MLM-HONEY_EXTRACTORS,1,1,0,413163,100%
3570,MLM-EAR_WAX_REMOVERS,34,38,0,413163,100%
3571,MLM-MOTORCYCLE_OIL_PUMPS,6,7,0,413163,100%
3572,MLM-STEPPERS,12,21,0,413163,100%
3573,MLM-NURSING_PADS,18,19,0,413163,100%
3574,MLM-TOY_VIRTUAL_PETS,7,5,0,413163,100%
3575,MLM-HUMIDIFIERS_AND_VAPORIZERS,22,33,0,413163,100%
3581,MLB-SNAP_RING_PLIERS,25,59,0,413163,100%
3585,MLB-AUTOMOTIVE_IGNITION_CYLINDERS,116,129,0,413163,100%
3588,MLB-INSTRUMENT_KNOBS,31,44,0,413163,100%
3589,MLM-CRUSHERS,3,3,0,413163,100%
3590,MLM-LIVESTOCK_EAR_TAGS,7,13,0,413163,100%
3593,MLB-FISH_TANK_ORNAMENTS,103,164,0,413163,100%
3594,MLB-EQUALIZERS,105,139,0,413163,100%
3598,MLM-BACKWASH_UNITS,25,35,0,413163,100%
3599,MLM-ENGINE_BEARINGS,7,10,0,413163,100%
3603,MLB-BABY_PLATES,165,220,0,413163,100%
3613,MLM-HORSE_BRAKES,5,10,0,413163,100%
3615,MLB-FILING_CABINETS,32,40,0,413163,100%
3618,MLM-KITCHEN_SIEVES,1,2,0,413163,100%
3619,MLB-INDUSTRIAL_DOUGH_KNEADERS,167,340,0,413163,100%
3624,MLB-AUTOMOTIVE_OXYGEN_SENSORS,420,433,0,413163,100%
3626,MLB-TAPE_DECKS,46,46,0,413163,100%
3630,MLM-SCHOOL_CHALKS,10,14,0,413163,100%
3631,MLM-HIKING_SPORT_HELMETS,6,1,0,413163,100%
3636,MLB-WASHING_AND_DRYER_MACHINE_BELTS,74,64,0,413163,100%
3639,MLB-PREFABRICATED_FIBERGLASS_POOLS,268,1147,0,413163,100%
3644,MLB-MIRROR_AND_PAINTING_FRAMES,103,184,0,413163,100%
3649,MLB-CLUTCH_SLAVE_CYLINDERS,194,178,0,413163,100%
3653,MLM-MOVABLE_CRANES,3,2,0,413163,100%
3654,MLM-MOTORCYCLE_SPEEDOMETERS,7,4,0,413163,100%
3655,MLM-EGG_HOLDERS,3,7,0,413163,100%
3657,MLM-GARDENING_AND_CONSTRUCTION_SHOVELS,3,2,0,413163,100%
3658,MLM-CLASSROOM_DESKS,16,13,0,413163,100%
3659,MLM-SLATWALL_PANELS,13,19,0,413163,100%
3661,MLM-URINALS,10,18,0,413163,100%
3663,MLM-LAPTOP_SWITCHES,2,2,0,413163,100%
3664,MLM-BAG_DISPENSERS,2,3,0,413163,100%
3665,MLB-TYPEWRITERS,84,84,0,413163,100%
3669,MLM-GONDOLA_SHELVING_UNITS,4,4,0,413163,100%
3670,MLM-INSTRUMENT_BOWS,3,4,0,413163,100%
3671,MLM-GUITAR_PEGS,10,13,0,413163,100%
3672,MLB-AUTOMOTIVE_OIL_FILTERS,320,342,0,413163,100%
3673,MLB-INDUSTRIAL_ICE_CREAM_MACHINES,281,482,0,413163,100%
3674,MLB-TRANSFER_SWITCHES,27,50,0,413163,100%
3675,MLM-DRONE_REPLACEMENT_CAMERAS,4,1,0,413163,100%
3679,MLB-INDUSTRIAL_AUTOCLAVES,18,24,0,413163,100%
3683,MLM-DEVICE_PROGRAMMERS,15,19,0,413163,100%
3684,MLM-WHEELCHAIR_CUSHIONS,11,29,0,413163,100%
3686,MLM-FOOD_PACKAGING_BOXES,18,18,0,413163,100%
3687,MLM-FAN_CAPACITORS,3,4,0,413163,100%
3688,MLM-EROTIC_SOCKS_AND_PANTYHOSES,3,1,0,413163,100%
3689,MLM-WHEEL_LUG_WRENCHES,13,6,0,413163,100%
3690,MLM-PINBALLS,13,10,0,413163,100%
3691,MLM-VEHICLE_BRAKE_FLUIDS,6,7,0,413163,100%
3692,MLM-TABLE_TENNIS_TABLES,10,11,0,413163,100%
3693,MLM-GPS_MAPS,10,23,0,413163,100%
3694,MLM-LABORATORY_PIPETTES,9,16,0,413163,100%
3699,MLM-FISHING_GLOVES_AND_MITTENS,21,21,0,413163,100%
3700,MLM-CUSHION_AND_PILLOW_COVERS,28,44,0,413163,100%
3701,MLM-MOTORCYCLE_GASOLINE_TANK_CAPS,16,8,0,413163,100%
3702,MLM-INTEGRATED_CIRCUITS,9,16,0,413163,100%
3703,MLM-HOOD_HINGES,11,19,0,413163,100%
3704,MLM-PET_COLOGNES_AND_PERFUMES,14,13,0,413163,100%
3707,MLM-BINDING_SPINES,17,11,0,413163,100%
3708,MLM-ANIMAL_AND_BALL_HOPPERS,13,34,0,413163,100%
3709,MLM-BASEBALL_AND_SOFTBALL_BACKPACKS_AND_BAGS,10,1,0,413163,100%
3712,MLB-AUTOMOTIVE_WATER_PUMPS,556,572,0,413163,100%
3713,MLB-INDIVIDUAL_LANDS_FOR_SALE,843,935,0,413163,100%
3715,MLB-CAR_DISTRIBUTORS,34,34,0,413163,100%
3719,MLB-INDUSTRIAL_STAPLES,59,95,0,413163,100%
3726,MLB-AUTOMOTIVE_ENGINE_ROCKER_ARMS,32,24,0,413163,100%
3730,MLM-TRAVEL_DOCUMENT_ORGANIZERS,17,26,0,413163,100%
3733,MLB-BROCHURES,121,171,0,413163,100%
3734,MLB-ICE_MAKERS,89,140,0,413163,100%
3737,MLB-HOSE_ADAPTERS,20,29,0,413163,100%
3738,MLM-MOUTHWASHES,11,16,0,413163,100%
3739,MLM-METAL_FOUNDRY_FURNACES,5,8,0,413163,100%
3741,MLM-COFFEE_AND_FOOD_DECORATIVE_STENCILS,1,1,0,413163,100%
3743,MLM-PASTA_MACHINES,14,14,0,413163,100%
3747,MLM-KIDS_TABLES_AND_CHAIRS_SETS,10,10,0,413163,100%
3748,MLM-TRANSFER_SWITCHES,1,1,0,413163,100%
3749,MLM-GARTER_BELTS,16,29,0,413163,100%
3753,MLB-SACHET_OPENERS,2,5,0,413163,100%
3756,MLB-MANUAL_HAND_PLANES,55,109,0,413163,100%
3758,MLB-AUTOMOTIVE_CLUTCH_MASTER_CYLINDERS,34,31,0,413163,100%
3762,MLB-ELECTRIC_TIRE_CHANGERS,36,60,0,413163,100%
3765,MLB-AUTOMOTIVE_AIR_SUSPENSION_KITS,98,302,0,413163,100%
3769,MLM-CAKE_COVER_PASTES,4,11,0,413163,100%
3770,MLM-FOOTBALL_SHOE_BAGS,13,6,0,413163,100%
3771,MLM-LOCK_PICKS,18,27,0,413163,100%
3772,MLM-TELEPROMPTERS,1,1,0,413163,100%
3773,MLM-MOTORCYCLE_HANDGUARDS,5,5,0,413163,100%
3774,MLM-POLY_MAILERS,2,1,0,413163,100%
3775,MLB-WALKMANS,36,21,0,413163,100%
3776,MLB-ENGINE_GASKET_SETS,226,248,0,413163,100%
3779,MLB-CUP_DISPENSERS,22,38,0,413163,100%
3788,MLM-CLEANING_GLOVES,4,5,0,413163,100%
3789,MLM-DRUM_BRAKE_WHEEL_CYLINDERS,6,6,0,413163,100%
3790,MLM-LATHE_CHUCKS,3,3,0,413163,100%
3792,MLM-EROTIC_DRESSES,5,1,0,413163,100%
3794,MLM-PAINTBALL_O_RINGS,6,8,0,413163,100%
3795,MLM-CMOS_CELL_BATTERIES,9,8,0,413163,100%
3796,MLM-FOLDING_SCREENS,17,23,0,413163,100%
3797,MLM-GLOW_PLUGS,2,1,0,413163,100%
3798,MLM-AUTOMOTIVE_SUNROOFS_ACTUATORS,3,2,0,413163,100%
3799,MLM-CLOTHING_RACKS,11,92,0,413163,100%
3800,MLM-CELLPHONE_SIGNAL_BOOSTER_ANTENNAS,33,29,0,413163,100%
3802,MLM-BIRD_BANDS,5,9,0,413163,100%
3807,MLB-CAR_AC_COMPRESSOR_PRESSURE_DELAY_SWITCHES,63,67,0,413163,100%
3812,MLB-LAPTOP_REPLACEMENT_ANTENNAS,4,7,0,413163,100%
3813,MLB-DRINK_PITCHERS,174,228,0,413163,100%
3816,MLM-COLLECTIBLE_MILITARY_HELMETS,13,16,0,413163,100%
3819,MLB-CLIMBING_ROPES,46,72,0,413163,100%
3822,MLB-WASTE_CONTAINERS,14,23,0,413163,100%
3824,MLB-DIGITAL_PICTURE_FRAMES,53,85,0,413163,100%
3828,MLM-MOUTH_GUARDS,7,8,0,413163,100%
3829,MLM-EFFECTS_MACHINE_FLUIDS,11,11,0,413163,100%
3830,MLM-PUSH_UP_BARS,1,0,0,413163,100%
3834,MLM-PICKUP_TRUCK_CAPS,17,18,0,413163,100%
3835,MLM-FINGERPRINT_READERS,11,11,0,413163,100%
3836,MLM-LABEL_MAKER_INK_ROLLERS,2,2,0,413163,100%
3837,MLM-MOTORCYCLE_DISTRIBUTION_CHAINS,11,15,0,413163,100%
3838,MLM-MANDOLINS,4,0,0,413163,100%
3839,MLM-MOTORCYCLE_BRAKE_DRUM_COVERS,8,9,0,413163,100%
3840,MLB-ELECTRIC_STAPLERS_AND_BRAD_NAILERS,44,95,0,413163,100%
3844,MLM-DOG_LIFE_JACKETS,2,3,0,413163,100%
3846,MLB-AUTOMOTIVE_WATER_PUMP_PULLEYS,19,21,0,413163,100%
3850,MLM-NAIL_POLISH_SHELVES,4,6,0,413163,100%
3853,MLB-HYGIENIC_WET_WIPES,28,21,0,413163,100%
3854,MLM-BB_CREAMS,17,30,0,413163,100%
3856,MLM-WASHING_MACHINE_TIMERS,3,0,0,413163,100%
3858,MLB-BOATS,176,292,0,413163,100%
3859,MLB-ENGINE_BEARINGS,99,83,0,413163,100%
3866,MLB-PLATE_BEER_WORT_CHILLERS,18,34,0,413163,100%
3867,MLB-LAMP_SHADES,95,114,0,413163,100%
3868,MLB-CANTEENS,111,108,0,413163,100%
3869,MLB-AQUARIUM_SUBSTRATES,144,224,0,413163,100%
3870,MLM-HENTAI_FIGURES,6,6,0,413163,100%
3871,MLM-TACTICAL_BOOTS,7,13,0,413163,100%
3872,MLM-CANDY_AND_BALL_VENDING_MACHINES,8,8,0,413163,100%
3873,MLM-HARD_AND_SOFT_CHEESES,10,16,0,413163,100%
3875,MLM-SKATEBOARD_WHEELS,14,14,0,413163,100%
3876,MLM-AUTOMOTIVE_ENGINE_COVERS,9,28,0,413163,100%
3877,MLM-TOY_PEDAL_GO_KARTS,11,7,0,413163,100%
3878,MLM-RODENT_TRAPS,30,44,0,413163,100%
3880,MLM-REFRIGERANT_GASES,12,15,0,413163,100%
3881,MLM-SALON_FURNITURE_PACKAGES,7,9,0,413163,100%
3882,MLM-POE_INJECTORS,13,14,0,413163,100%
3883,MLM-CAMERA_SHOE_MOUNT_ADAPTERS,7,5,0,413163,100%
3885,MLM-HOOKAHS,14,22,0,413163,100%
3887,MLB-SALON_TROLLEYS,98,172,0,413163,100%
3888,MLB-IDLER_ARMS,151,124,0,413163,100%
3890,MLM-NGV_FULL_EQUIPMENTS,4,8,0,413163,100%
3893,MLB-FISHING_SNAPS,88,113,0,413163,100%
3896,MLM-ELECTRICAL_SUPPLIES,28,27,0,413163,100%
3897,MLM-BICYCLE_ELECTRIC_ENGINE_KITS,6,9,0,413163,100%
3898,MLM-TUTUS,6,6,0,413163,100%
3900,MLB-BUBBLE_LEVELS,19,17,0,413163,100%
3901,MLM-COLLECTIBLE_POSTAGE_STAMPS,7,10,0,413163,100%
3902,MLM-SNARE_DRUM_WIRES,2,2,0,413163,100%
3903,MLM-LIVESTOCK_DRINKERS,7,11,0,413163,100%
3904,MLM-CONTROLLER_PADS,6,8,0,413163,100%
3905,MLM-HOME_REPELLENTS,4,7,0,413163,100%
3906,MLM-SAXOPHONE_MOUTHPIECES,5,6,0,413163,100%
3907,MLM-CLOTHESPINS,7,9,0,413163,100%
3908,MLM-POOL_COVERS,6,6,0,413163,100%
3909,MLM-MEDICAL_TOURNIQUETS,13,30,0,413163,100%
3910,MLM-HAND_WINCHES,10,18,0,413163,100%
3911,MLM-KITCHEN_TOWEL_RACKS,2,1,0,413163,100%
3912,MLM-MANICURE_AND_PEDICURE_ELECTRONIC_EXFOLIATORS_AND_FILES,11,9,0,413163,100%
3915,MLB-RIVETS,53,63,0,413163,100%
3916,MLB-COMPUTER_REMOTE_CONTROLS,22,35,0,413163,100%
3922,MLM-ELECTRIC_FIREPLACES,11,17,0,413163,100%
3923,MLM-AUTOMOTIVE_FOG_LIGHT_SWITCHES,3,4,0,413163,100%
3924,MLB-ZIPPERS,60,117,0,413163,100%
3925,MLM-COMPUTER_MONITOR_RISER_STANDS,6,7,0,413163,100%
3926,MLM-PHOTOGRAPHIC_EQUIPMENT_SUITCASES,7,1,0,413163,100%
3927,MLM-NETWORK_TOOL_KITS,8,13,0,413163,100%
3928,MLM-GUIROS,8,11,0,413163,100%
3929,MLM-MOTORCYCLE_ENGINE_OIL_PANS,2,1,0,413163,100%
3930,MLB-TRAVEL_AND_TRAINING_BAGS,62,65,0,413163,100%
3931,MLM-AUTOMOTIVE_CROSSMEMBERS,5,3,0,413163,100%
3933,MLM-IGNITION_KNOCK_SENSORS,6,3,0,413163,100%
3937,MLB-LIQUOR_FLASKS,61,124,0,413163,100%
3938,MLM-HAND_TOWELS,9,12,0,413163,100%
3939,MLB-BICYCLE_CRANKSETS,352,491,0,413163,100%
3941,MLB-SUSHI_MAKERS,20,18,0,413163,100%
3943,MLB-AUTOMOTIVE_SKIRTS,419,514,0,413163,100%
3949,MLM-SODS,11,17,0,413163,100%
3950,MLM-AIRSOFT_GUN_REPLACEMENT_SPRINGS,13,15,0,413163,100%
3951,MLM-LONGBOARDS,16,13,0,413163,100%
3953,MLM-DOG_SOAPS,7,4,0,413163,100%
3954,MLM-PNEUMATIC_VALVES,5,26,0,413163,100%
3955,MLM-PLAYGROUND_SWING_SETS,14,18,0,413163,100%
3956,MLM-CAR_DISTRIBUTOR_KITS,6,6,0,413163,100%
3957,MLM-TENNIS_BAGS,11,9,0,413163,100%
3958,MLM-PACKAGING_CONTAINERS,23,20,0,413163,100%
3963,MLM-JET_SKIS,4,5,0,413163,100%
3964,MLM-AUTOMOTIVE_SPEEDOMETER_CABLES,10,10,0,413163,100%
3965,MLM-TOY_KITES,4,4,0,413163,100%
3966,MLM-ALL_TERRAIN_VEHICLE_WHEELS,5,6,0,413163,100%
3967,MLM-AUTOMOTIVE_SUNROOFS,5,12,0,413163,100%
3969,MLB-WOOD_FLOORINGS,166,332,0,413163,100%
3970,MLB-ECT_SENSORS,278,316,0,413163,100%
3971,MLM-CAMERA_FIELD_MONITORS,4,6,0,413163,100%
3972,MLM-HYDROMETERS,3,0,0,413163,100%
3973,MLM-EDGE_BANDING_MACHINES,7,3,0,413163,100%
3974,MLM-PET_DOORS,18,33,0,413163,100%
3975,MLM-ENGINE_TAPPET_GUIDE_HOLDS,6,6,0,413163,100%
3976,MLB-JUICERS,70,150,0,413163,100%
3978,MLB-GAS_DETECTORS,27,52,0,413163,100%
3980,MLB-PICKGUARDS,77,91,0,413163,100%
3983,MLB-SKATEBOARD_TRUCKS,63,111,0,413163,100%
3984,MLB-CAMPING_THERMAL_MATS,75,100,0,413163,100%
3985,MLM-BABY_WELCOME_SIGNS,4,6,0,413163,100%
3986,MLB-WATCH_RINGS,16,21,0,413163,100%
3989,MLB-POOL_AGREEMENTS,92,190,0,413163,100%
3990,MLM-RFID_BRACELETS,1,2,0,413163,100%
3992,MLB-LIGHTER_FLUIDS,17,11,0,413163,100%
3996,MLM-FLOOR_CRANES,2,2,0,413163,100%
4001,MLM-SCREEN_PRINTING_FRAMES,6,8,0,413163,100%
4002,MLB-SOLDERING_MACHINES,133,850,0,413163,100%
4004,MLB-BABY_FOOD_DISPENSER_SPOONS,21,43,0,413163,100%
4006,MLB-SCALEXTRIC_CARS,34,64,0,413163,100%
4008,MLM-SWEETENERS,8,11,0,413163,100%
4010,MLM-KITCHEN_CORERS_AND_PITTERS,2,2,0,413163,100%
4011,MLM-AUTOMOTIVE_ENGINE_TIMING_CHAINS,9,17,0,413163,100%
4012,MLM-MIRROR_BALLS,4,4,0,413163,100%
4013,MLM-MOTORCYCLE_AND_ALL_TERRAIN_VEHICLE_LOADING_RAMPS,9,7,0,413163,100%
4015,MLM-SEX_BOARD_GAMES,10,11,0,413163,100%
4025,MLM-MUSICAL_COWBELLS,5,4,0,413163,100%
4026,MLM-AQUARIUM_SUBSTRATES,4,5,0,413163,100%
4029,MLB-MOTORCYCLE_STARTER_BRUSH_HOLDERS,7,5,0,413163,100%
4030,MLB-CYCLING_GLOVES_AND_MITTENS,28,55,0,413163,100%
4034,MLB-MOTORCYCLE_ENGINES,251,311,0,413163,100%
4037,MLM-BROOMS,9,15,0,413163,100%
4039,MLB-AUTOMOTIVE_SEATS,586,714,0,413163,100%
4040,MLM-TORSION_BARS,13,22,0,413163,100%
4041,MLM-ANILINE_DYES,7,10,0,413163,100%
4042,MLB-CYMBALS,316,376,0,413163,100%
4045,MLB-BOX_SPRING_BASES,197,461,0,413163,100%
4046,MLB-MOTORCYCLE_BRAKE_MASTER_CYLINDERS,13,19,0,413163,100%
4047,MLB-AUTOMOTIVE_STEERING_WHEEL_SWITCHES,185,262,0,413163,100%
4049,MLM-TEXTURE_COATINGS,1,0,0,413163,100%
4050,MLM-PET_SEAT_BELTS,4,4,0,413163,100%
4051,MLB-AV_RECEIVERS,443,651,0,413163,100%
4053,MLM-RUBBER_STAMP_INK_REFILLS,4,3,0,413163,100%
4054,MLM-FOOTBALL_GOALS,1,0,0,413163,100%
4055,MLM-STAMP_PADS,2,1,0,413163,100%
4056,MLM-CAN_OPENERS,6,5,0,413163,100%
4057,MLM-SEWING_NEEDLES,3,3,0,413163,100%
4058,MLM-SLEDGEHAMMERS,1,3,0,413163,100%
4059,MLM-PERGOLAS,8,37,0,413163,100%
4061,MLB-AUTOMOTIVE_ENGINE_CYLINDER_HEADS,445,486,0,413163,100%
4064,MLM-BRAKE_DRUMS,15,15,0,413163,100%
4065,MLM-ENGINE_COOLING_FAN_CLUTCHES,9,4,0,413163,100%
4066,MLM-FLUORESCENT_PAINTS,19,45,0,413163,100%
4067,MLM-GAME_CONSOLE_MEDIA_REMOTE_CONTROLS,4,3,0,413163,100%
4070,MLM-SERVICE_CARTS,5,5,0,413163,100%
4073,MLM-BABY_TOOTHBRUSHES,5,2,0,413163,100%
4074,MLM-DECORATIVE_CAGES,6,8,0,413163,100%
4079,MLB-LIQUORS,143,210,0,413163,100%
4081,MLM-CEREAL_BARS,5,14,0,413163,100%
4082,MLB-WINE_CELLARS,87,118,0,413163,100%
4085,MLM-BREATHALYSERS,4,3,0,413163,100%
4086,MLM-MODELISM_BATTERY_CHARGERS,2,2,0,413163,100%
4087,MLM-AUTOMOTIVE_POWER_STEERING_OIL_PRESSURE_SENSORS,7,14,0,413163,100%
4090,MLM-TIPPED_PLIERS,11,10,0,413163,100%
4093,MLM-VEHICLE_COOLANTS,19,24,0,413163,100%
4094,MLB-SAILBOATS,129,184,0,413163,100%
4095,MLM-IRRIGATION_KITS,8,19,0,413163,100%
4097,MLB-DRUM_BRAKE_SHOES,180,214,0,413163,100%
4098,MLM-MARTIAL_ARTS_SHIN_GUARDS,18,15,0,413163,100%
4099,MLM-BABY_PLATES,12,52,0,413163,100%
4100,MLM-AUTOMOTIVE_ENGINE_OIL_FILLER_CAPS,17,26,0,413163,100%
4101,MLM-SURFBOARD_LEASHES,5,6,0,413163,100%
4102,MLM-CAR_GEARBOXES,19,19,0,413163,100%
4103,MLM-CACHACAS,1,5,0,413163,100%
4104,MLM-SOLDERING_STATIONS,14,28,0,413163,100%
4105,MLM-EROTIC_BABYDOLLS,9,3,0,413163,100%
4108,MLB-AUTOMOTIVE_RADIATOR_SUPPORTS,205,266,0,413163,100%
4109,MLM-BEANS,5,3,0,413163,100%
4111,MLM-PRINTER_AND_PHOTOCOPIER_GEARS,3,4,0,413163,100%
4113,MLB-MOULDINGS,212,551,0,413163,100%
4114,MLB-BAKERY_RACKS,10,8,0,413163,100%
4116,MLM-AUTOMOTIVE_BRAKE_CALIPERS,10,7,0,413163,100%
4117,MLM-CONCRETE_VIBRATORS,3,2,0,413163,100%
4118,MLM-CAMERA_SCREEN_PROTECTORS,6,2,0,413163,100%
4119,MLM-SPORT_DRESSES,12,12,0,413163,100%
4120,MLM-CAMERA_SLIDERS,1,0,0,413163,100%
4122,MLM-MOTORCYCLE_GEAR_SHIFT_SHAFTS,3,2,0,413163,100%
4123,MLM-DENTAL_HIGH_SPEED_HANDPIECES,2,2,0,413163,100%
4124,MLM-INSTANT_SOUPS_AND_CREAMS,6,5,0,413163,100%
4125,MLB-MOTORCYCLE_HANDLEBAR_YOKES,43,50,0,413163,100%
4126,MLB-COOKING_BAGS,19,16,0,413163,100%
4127,MLB-TEA_KETTLES,172,306,0,413163,100%
4129,MLM-COOKING_YEASTS,6,7,0,413163,100%
4133,MLB-RACKS_AND_PINIONS,1232,1623,0,413163,100%
4134,MLM-PADDLE_TENNIS_RACKETS,3,6,0,413163,100%
4135,MLM-PLASMA_CUTTERS,22,33,0,413163,100%
4136,MLM-BADGE_AND_CARD_HOLDERS,1,1,0,413163,100%
4138,MLB-DULCE_DE_LECHE,128,271,0,413163,100%
4139,MLM-COMPOSTERS,11,4,0,413163,100%
4140,MLM-BABY_CREAMS_AND_OINTMENTS,7,9,0,413163,100%
4141,MLM-LENS_ADAPTER_RINGS,4,8,0,413163,100%
4142,MLM-SKIN_REPELLENTS,28,31,0,413163,100%
4143,MLM-CARD_PRINTERS,16,25,0,413163,100%
4149,MLM-GAS_GRILLS,7,8,0,413163,100%
4150,MLM-CRICKETS,1,1,0,413163,100%
4151,MLM-HOME_BOTTLE_STANDS,20,34,0,413163,100%
4153,MLM-AUTOMOTIVE_RAG_JOINTS,3,2,0,413163,100%
4155,MLB-SUSPENSION_BALL_JOINTS,459,522,0,413163,100%
4165,MLB-SALON_FURNITURE,105,177,0,413163,100%
4166,MLM-COMPUTER_MOTION_CONTROLLERS,4,3,0,413163,100%
4174,MLB-AUTOMOTIVE_REAR_BODY_TAIL_LIGHT_PANELS,59,31,0,413163,100%
4177,MLB-CAMERA_REMOTE_CONTROLS,27,59,0,413163,100%
4179,MLB-HOUSES_FOR_VACATION_RENTAL,181,236,0,413163,100%
4182,MLB-AUTOMOTIVE_BRAKE_KITS,137,190,0,413163,100%
4184,MLB-HAND_DRAIN_PUMPS,5,14,0,413163,100%
4185,MLM-BILLIARD_BALLS,5,3,0,413163,100%
4186,MLM-POLYURETHANE_LIQUID_FOAMS,11,14,0,413163,100%
4187,MLM-TACTICAL_HATS_AND_CAPS,2,1,0,413163,100%
4188,MLM-PIPES_AND_TUBES,28,33,0,413163,100%
4189,MLB-BUSINESS_TELEPHONE_SYSTEMS,43,46,0,413163,100%
4190,MLB-AQUARIUM_SALTS,22,31,0,413163,100%
4192,MLB-BICYCLE_FRAMES,813,1510,0,413163,100%
4196,MLB-FOLDING_SCREENS,86,145,0,413163,100%
4197,MLM-ACCORDION_CASES_AND_BAGS,2,2,0,413163,100%
4198,MLM-NON_RETURN_DRAIN_VALVES,1,1,0,413163,100%
4199,MLM-BICYCLE_EXTRACTOR_TOOLS,1,3,0,413163,100%
4200,MLM-PORTION_MARKERS,5,8,0,413163,100%
4203,MLB-VEHICLE_CYLINDER_LINERS,52,44,0,413163,100%
4206,MLB-COMPUTER_USB_LAMPS,38,56,0,413163,100%
4207,MLB-AUTOMOTIVE_FUSE_BOXES,73,90,0,413163,100%
4208,MLB-AUTOMOTIVE_AC_FULL_KITS,294,682,0,413163,100%
4210,MLB-GATEWAYS,38,53,0,413163,100%
4211,MLB-MULTIPURPOSE_CLEANERS_AND_DISINFECTANTS,22,52,0,413163,100%
4216,MLM-LATHES,7,11,0,413163,100%
4217,MLM-EROTIC_PARTY_SUPPLIES,15,19,0,413163,100%
4218,MLM-NIPPLE_CLAMPS,4,6,0,413163,100%
4219,MLM-EROTIC_CHAIRS_AND_SOFAS,3,4,0,413163,100%
4220,MLM-KIDS_LEARNING_TOWERS,3,1,0,413163,100%
4221,MLM-CROSSBOWS,14,12,0,413163,100%
4222,MLM-MAGNETIC_CARD_READERS,3,11,0,413163,100%
4224,MLM-CUTICLE_REMOVERS,15,20,0,413163,100%
4227,MLM-BICYCLE_CHAIN_CUTTERS,5,5,0,413163,100%
4231,MLM-SPARKLING_WATER_MAKERS,3,11,0,413163,100%
4236,MLB-MODEL_AIRCRAFT_HELICOPTERS,191,269,0,413163,100%
4237,MLB-RIVET_GUNS,78,152,0,413163,100%
4239,MLB-AUTOMOTIVE_HEAD_GASKETS,180,179,0,413163,100%
4240,MLM-PERFORMANCE_SUSPENSION_KITS,7,6,0,413163,100%
4243,MLM-HAND_BRAKE_CABLES,8,5,0,413163,100%
4244,MLM-ESTHETIC_ELECTROPORATORS,11,31,0,413163,100%
4249,MLB-EROTIC_COSTUMES,46,48,0,413163,100%
4250,MLM-BUILDINGS_FOR_RENT,4,3,0,413163,100%
4251,MLM-EMPANADAS,2,3,0,413163,100%
4252,MLM-HABERDASHERY_BUTTONS,9,5,0,413163,100%
4253,MLM-DANCE_COSTUMES,11,6,0,413163,100%
4254,MLM-AMERICAN_FOOTBALL_SHOES,38,22,0,413163,100%
4255,MLM-INDUSTRIAL_SILOS,2,5,0,413163,100%
4257,MLB-VIDEOCASSETTE_PLAYERS,14,9,0,413163,100%
4261,MLB-MOTORCYCLE_HANDLEBAR_GRIPS,281,432,0,413163,100%
4262,MLB-ANTIQUE_CHAIRS,52,45,0,413163,100%
4263,MLM-CANVAS_AND_WOODEN_FRAMES,6,10,0,413163,100%
4264,MLM-CHESTS,6,8,0,413163,100%
4265,MLM-PUSH_BUTTONS,17,18,0,413163,100%
4266,MLB-AUTOMOTIVE_TRUNK_LIDS,243,224,0,413163,100%
4267,MLB-AUTOMOTIVE_HOOD_RELEASE_CABLES,66,77,0,413163,100%
4269,MLB-COMBUSTION_WATER_PUMPS,26,50,0,413163,100%
4270,MLB-TRAINING_MASKS,6,9,0,413163,100%
4275,MLM-POWER_STEERING_HOSES,17,18,0,413163,100%
4276,MLB-ROTISSERIE_OVENS,141,247,0,413163,100%
4280,MLB-CONTROLLER_PADS,28,32,0,413163,100%
4282,MLB-BILLIARD_TABLES,246,552,0,413163,100%
4283,MLB-AUTOMOTIVE_EXTERIOR_DOOR_HANDLES,78,76,0,413163,100%
4285,MLM-AUTOMOTIVE_WHEEL_SPACERS,8,7,0,413163,100%
4286,MLB-TOILET_LIGHTS,25,48,0,413163,100%
4289,MLB-CLIMBING_HOLDS,17,27,0,413163,100%
4290,MLB-COLOR_POWDERS,16,20,0,413163,100%
4291,MLB-POOL_MAIN_DRAINS,16,17,0,413163,100%
4293,MLB-FOOD_CARTS,32,72,0,413163,100%
4294,MLM-COOKING_TORCHES,7,0,0,413163,100%
4295,MLM-DRUM_PRACTICE_PADS,6,2,0,413163,100%
4296,MLM-ELECTRIC_DRILL_AND_SCREWDRIVER_BITS,23,23,0,413163,100%
4297,MLM-DIGESTIVE_MEDICINES,10,6,0,413163,100%
4298,MLM-BIO_FIREPLACES,4,7,0,413163,100%
4299,MLM-VEHICLE_TOW_ROPES,5,4,0,413163,100%
4300,MLM-TRANSFER_CASES,1,1,0,413163,100%
4303,MLB-CHAMPAGNES,103,114,0,413163,100%
4306,MLB-AUTOMOTIVE_FUEL_PRESSURE_REGULATORS,223,257,0,413163,100%
4309,MLB-AUTOMOTIVE_WIRE_HARNESSES,32,49,0,413163,100%
4311,MLM-OFFICE_RUBBER_BANDS,3,0,0,413163,100%
4313,MLM-COLLECTIBLE_PRODUCTS,2,3,0,413163,100%
4314,MLM-AUTOMOTIVE_SEAT_BELT_COVERS,6,6,0,413163,100%
4315,MLM-CAR_ENGINE_CAMSHAFT_SENSORS,6,7,0,413163,100%
4316,MLM-PRINTER_BEARINGS,3,4,0,413163,100%
4317,MLM-HOT_WATER_BOTTLES,6,4,0,413163,100%
4318,MLM-ELECTRIC_SQUEEZERS,17,12,0,413163,100%
4319,MLM-SABELS,14,22,0,413163,100%
4320,MLM-CAR_EMERGENCY_KITS,10,16,0,413163,100%
4322,MLM-MOTORCYCLE_AIR_FILTER_BOXES,2,1,0,413163,100%
4323,MLM-MOTORCYCLE_TRANSMISSION_KITS,14,13,0,413163,100%
4325,MLM-BUTTER_PAPERS,1,0,0,413163,100%
4327,MLB-VEHICLE_FUEL_FILTERS,441,499,0,413163,100%
4329,MLB-CONSTRUCTION_PROFILES,33,36,0,413163,100%
4330,MLB-REPTILE_AND_AMPHIBIAN_TERRARIUMS,50,49,0,413163,100%
4332,MLM-GEOMETRY_RULERS_PROTRACTORS_AND_SET_SQUARES,20,25,0,413163,100%
4334,MLB-DISPOSABLE_PARTY_KITS,172,255,0,413163,100%
4335,MLB-ULTRABOOKS,120,167,0,413163,100%
4339,MLM-DOOR_STOPPERS,7,6,0,413163,100%
4342,MLB-DECORATIVE_CAGES,42,57,0,413163,100%
4343,MLM-PHOTOCOPIER_DEVELOPERS,4,9,0,413163,100%
4346,MLM-AUTOMOTIVE_AC_FULL_KITS,5,2,0,413163,100%
4347,MLM-BARBECUE_TOOL_SETS,2,7,0,413163,100%
4352,MLB-PET_TOY_BALLS,52,375,0,413163,100%
4354,MLB-ENGINE_VALVES,67,77,0,413163,100%
4362,MLB-GOLF_CLUBS_IRONS,2,1,0,413163,100%
4363,MLM-BABY_SAFETY_LOCKS,9,11,0,413163,100%
4364,MLM-PHOTOGRAPHIC_FILM_ROLLS,3,3,0,413163,100%
4367,MLB-RESISTORS,113,138,0,413163,100%
4369,MLB-OFFICES_FOR_RENT,99,74,0,413163,100%
4371,MLB-VOLTAGE_REGULATORS,92,127,0,413163,100%
4372,MLB-AUTOMOTIVE_FOG_LIGHT_SWITCHES,212,258,0,413163,100%
4374,MLB-SPRAY_PAINTS,59,62,0,413163,100%
4375,MLB-FISH_TANKS,430,789,0,413163,100%
4377,MLM-ASPHALT_PAVERS,2,2,0,413163,100%
4381,MLM-PRUNING_SHEARS,10,15,0,413163,100%
4383,MLB-MODEL_RAILROADING_ACCESSORIES,47,49,0,413163,100%
4384,MLM-MOTORCYCLE_RADIATOR_PROTECTORS,2,2,0,413163,100%
4385,MLB-TPS_SENSORS,71,85,0,413163,100%
4387,MLM-DENTAL_FLOSSES,9,16,0,413163,100%
4388,MLM-EROTIC_CREAMS,4,3,0,413163,100%
4389,MLB-DRIVE_SHAFTS,41,41,0,413163,100%
4390,MLB-MUSICAL_KEYBOARD_CASES_AND_BAGS,48,61,0,413163,100%
4391,MLB-METAL_NAILS,40,56,0,413163,100%
4392,MLM-FISH_TANK_NETS,4,2,0,413163,100%
4395,MLB-HOOKAH_CHARCOAL,120,230,0,413163,100%
4398,MLB-ELECTRIC_BICYCLES,199,419,0,413163,100%
4406,MLB-AUTOMOTIVE_SPEED_SENSORS,162,172,0,413163,100%
4407,MLM-AUTOMOTIVE_GASOLINE_VAPOR_KITS,1,0,0,413163,100%
4408,MLM-PC_THERMAL_COMPOUND_PASTES,5,19,0,413163,100%
4409,MLM-SHAWLS,10,11,0,413163,100%
4411,MLM-PAINTS_AND_ACCESSORIES,10,10,0,413163,100%
4413,MLB-MANICURE_TABLES,102,249,0,413163,100%
4415,MLB-CAMERA_BATTERY_GRIPS,41,48,0,413163,100%
4418,MLB-CERAMIC_TILES,171,437,0,413163,100%
4420,MLB-BICYCLE_REAR_DERAILLEURS,148,218,0,413163,100%
4422,MLB-NAUTICAL_CLEATS,1,1,0,413163,100%
4427,MLB-TEA_INFUSERS,43,93,0,413163,100%
4430,MLB-MOTORCYCLE_ALTERNATOR_STATORS,115,128,0,413163,100%
4431,MLB-DRONE_REPLACEMENT_CAMERAS,14,13,0,413163,100%
4432,MLM-METAL_WIRES,8,10,0,413163,100%
4433,MLM-KITCHEN_SINKS,1,1,0,413163,100%
4434,MLM-ELECTRIC_FOOD_STEAMERS,4,4,0,413163,100%
4435,MLB-VIDEOKE_TRANSFER_PACKS,58,75,0,413163,100%
4439,MLB-MOTOR_STARTERS,35,27,0,413163,100%
4440,MLM-AUTOMOTIVE_ENGINE_CAMSHAFT_TIMING_GEARS,4,3,0,413163,100%
4442,MLM-SAXOPHONE_AND_CLARINET_REEDS,2,1,0,413163,100%
4443,MLM-DISTILLERS,3,4,0,413163,100%
4444,MLM-KIDS_MICROPHONES,11,17,0,413163,100%
4447,MLB-MANUAL_GNOCCHI_MAKERS,16,28,0,413163,100%
4449,MLM-PARTY_INFLATABLES,1,2,0,413163,100%
4450,MLM-DIGITAL_PICTURE_FRAMES,13,34,0,413163,100%
4451,MLM-ENGINE_CONNECTING_RODS,9,20,0,413163,100%
4453,MLM-TOOL_CABINETS,5,5,0,413163,100%
4455,MLM-TACTICAL_HANDCUFF_CASES,7,11,0,413163,100%
4456,MLM-SNOWWEAR_SETS,1,0,0,413163,100%
4457,MLM-DRAIN_TRAPS,8,7,0,413163,100%
4458,MLB-SNARE_DRUM_WIRES,15,20,0,413163,100%
4459,MLM-EYELASH_CURLERS,15,26,0,413163,100%
4463,MLB-OTHER_VEHICLES,386,541,0,413163,100%
4465,MLB-RADIAL_INDUCTORS,49,57,0,413163,100%
4467,MLB-CUPCAKE_STANDS,20,23,0,413163,100%
4471,MLB-NAIL_POLISH_RING_HOLDERS,4,5,0,413163,100%
4472,MLM-WATCH_REPAIR_TOOL_KITS,11,14,0,413163,100%
4475,MLM-SHAVING_BRUSHES,11,10,0,413163,100%
4478,MLB-HAND_WIRE_BRUSHES,9,13,0,413163,100%
4481,MLB-MUSICAL_WASHBOARDS,4,6,0,413163,100%
4482,MLB-TOBACCO_PIPES,109,200,0,413163,100%
4484,MLB-SPARKLING_WINES,29,20,0,413163,100%
4485,MLB-AUTOMOTIVE_TURBOCHARGER_DOWNPIPES,45,39,0,413163,100%
4488,MLM-TRENCHERS,3,3,0,413163,100%
4489,MLM-ELECTRIC_MASSAGES_SEATS,5,6,0,413163,100%
4490,MLM-FURNITURE_KNOBS,3,0,0,413163,100%
4491,MLB-AUTOMOBILE_DOOR_GLASSES,93,104,0,413163,100%
4494,MLB-PRINTER_AND_PHOTOCOPIER_GEARS,20,30,0,413163,100%
4500,MLB-AUTOMOTIVE_WATER_PUMP_HOUSINGS,12,17,0,413163,100%
4501,MLM-PEDALBOARD_CASES,2,2,0,413163,100%
4502,MLM-DECORATIVE_PLATES,3,4,0,413163,100%
4506,MLB-AUTOMOTIVE_SIDE_VIEW_MIRROR_GLASSES,267,256,0,413163,100%
4507,MLM-AUTOMOTIVE_SPARE_TIRE_COVERS,8,8,0,413163,100%
4508,MLB-INJECTION_PUMPS,135,140,0,413163,100%
4509,MLB-PIANOS,114,190,0,413163,100%
4510,MLM-FISHING_SHIRTS,8,20,0,413163,100%
4512,MLB-PHOTOCONTROLS,19,33,0,413163,100%
4513,MLM-WASHING_MACHINE_MOTORS,7,9,0,413163,100%
4514,MLM-MODEL_RAILROADING_WAGONS,7,12,0,413163,100%
4516,MLB-CAR_FRONT_MASKS,78,79,0,413163,100%
4517,MLB-FOOTWEAR_CLEANERS_AND_POLISHES,13,16,0,413163,100%
4521,MLM-COOKIES,22,27,0,413163,100%
4524,MLB-JET_SKIS,341,488,0,413163,100%
4525,MLM-PET_FOOTWEAR,22,18,0,413163,100%
4526,MLM-AFTERSHAVES,7,4,0,413163,100%
4528,MLM-BABY_BOTTLE_NIPPLES,7,11,0,413163,100%
4529,MLM-FORCE_GAUGES,2,3,0,413163,100%
4532,MLM-BICYCLE_CRANKSETS,16,17,0,413163,100%
4533,MLM-ARCADE_MACHINE_BUTTONS,10,19,0,413163,100%
4534,MLM-BICYCLE_WHEELS,3,4,0,413163,100%
4535,MLB-TUBAS,95,131,0,413163,100%
4536,MLB-STATIONARY_ENGINES,172,337,0,413163,100%
4537,MLB-CERAMIC_BIDETS,1,1,0,413163,100%
4540,MLB-CLASSICAL_GUITARS,62,97,0,413163,100%
4541,MLB-AUTOMOTIVE_NERF_BARS,347,445,0,413163,100%
4543,MLB-MOTORCYCLE_AIR_FILTERS,198,281,0,413163,100%
4546,MLB-ARCHERY_BOWS,197,395,0,413163,100%
4547,MLB-HEDGE_TRIMMERS,53,80,0,413163,100%
4548,MLB-BRAKE_DRUMS,135,155,0,413163,100%
4549,MLM-ADULT_ELECTRIC_TRICYCLES,2,5,0,413163,100%
4551,MLB-WETSUITS,68,55,0,413163,100%
4552,MLM-AIR_CONDITIONER_FILTERS,2,4,0,413163,100%
4553,MLM-ROWING_MACHINES,8,9,0,413163,100%
4554,MLM-WINDSOCKS,4,8,0,413163,100%
4555,MLM-TATTOO_NEEDLES,4,3,0,413163,100%
4557,MLB-HEATER_CORES,35,37,0,413163,100%
4562,MLB-MOTORCYCLE_ENGINE_CONNECTING_RODS,80,95,0,413163,100%
4563,MLB-COLLECTIBLE_MILITARY_JACKETS,50,65,0,413163,100%
4566,MLM-COMPUTER_DIAGNOSTIC_CARDS,1,2,0,413163,100%
4567,MLM-MATE_GOURDS,1,2,0,413163,100%
4569,MLB-AUTOMOTIVE_DOORS,234,208,0,413163,100%
4570,MLM-DISTILLATION_FLASKS,6,2,0,413163,100%
4571,MLM-SCULPTURED_NAIL_BUILDER_GELS,6,5,0,413163,100%
4573,MLB-HOT_TUBS,290,637,0,413163,100%
4574,MLM-MOTORCYCLE_AND_ALL_TERRAIN_VEHICLE_CARGO_NETS,14,34,0,413163,100%
4575,MLM-GREASE_GUNS,4,10,0,413163,100%
4577,MLB-HORSES_AND_MARES,227,343,0,413163,100%
4579,MLB-ROLL_BARS,146,191,0,413163,100%
4581,MLM-WASHING_MACHINE_AGITATORS,10,12,0,413163,100%
4582,MLM-PRICE_TAG_HOLDERS,5,13,0,413163,100%
4583,MLB-OTHER_BOATS,5,4,0,413163,100%
4584,MLB-ENGINE_OIL_PRESSURE_SENSORS,143,133,0,413163,100%
4586,MLM-BREAD_CRUMBS,1,0,0,413163,100%
4587,MLM-WHEELBARROWS,8,6,0,413163,100%
4588,MLM-SKATEBOARD_BEARINGS,13,16,0,413163,100%
4589,MLM-AUTOMOTIVE_HOOD_RELEASE_CABLES,2,3,0,413163,100%
4593,MLB-LECTERNS_AND_PULPITS,37,50,0,413163,100%
4594,MLB-TENNIS_NETS,16,29,0,413163,100%
4595,MLM-INVERSION_TABLES,10,12,0,413163,100%
4596,MLM-IGNITION_SWITCH_ACTUATORS,8,6,0,413163,100%
4597,MLB-MEDICINE_BALLS,59,89,0,413163,100%
4598,MLB-MOTORCYCLE_EMBLEMS,109,164,0,413163,100%
4603,MLM-PET_ULTRASONIC_REPELLENTS,3,3,0,413163,100%
4605,MLM-COLLECTIBLE_POSTCARDS,3,3,0,413163,100%
4606,MLM-TOY_PRETEND_SUITCASES,7,5,0,413163,100%
4607,MLB-TELEPHONE_CABLES,28,28,0,413163,100%
4609,MLB-SILAGE_BAGS,48,47,0,413163,100%
4611,MLB-OSCILLOSCOPES,114,185,0,413163,100%
4613,MLM-BOOKENDS,3,2,0,413163,100%
4617,MLB-DISC_BRAKE_CALIPER_PISTONS,24,35,0,413163,100%
4618,MLB-PILATES_REFORMERS,31,42,0,413163,100%
4619,MLB-VEHICLE_TIRE_VALVES,200,278,0,413163,100%
4620,MLM-VEHICLE_BRAKE_HYDRAULIC_HOSES,6,6,0,413163,100%
4621,MLB-SEX_BOARD_GAMES,24,25,0,413163,100%
4624,MLB-BABY_JOURNALS,60,96,0,413163,100%
4626,MLB-CANNED_AND_PRESERVED_FOOD,51,51,0,413163,100%
4627,MLM-APARTMENTS_FOR_VACATION_RENTAL,5,16,0,413163,100%
4631,MLM-HORSE_SUPPLEMENTS,11,20,0,413163,100%
4632,MLM-DRONE_BACKPACKS_AND_CASES,9,5,0,413163,100%
4634,MLB-LIFE_RINGS,27,37,0,413163,100%
4635,MLB-HAND_TOWELS,46,55,0,413163,100%
4636,MLB-STRING_INSTRUMENT_BRIDGES,124,129,0,413163,100%
4637,MLM-PUNCHING_BAGS_SUPPORTS,5,5,0,413163,100%
4638,MLM-ICE_SKATES,4,3,0,413163,100%
4639,MLM-CRANKSHAFTS,5,4,0,413163,100%
4640,MLB-MULTI_TOOL_KNIVES,101,101,0,413163,100%
4642,MLB-ENGINE_CONTROL_MODULES,634,743,0,413163,100%
4643,MLB-BRICKS,84,181,0,413163,100%
4644,MLB-ENGINE_CRANKSHAFT_POSITION_SENSORS,212,192,0,413163,100%
4645,MLB-CAR_POWER_STEERING_PUMPS,254,237,0,413163,100%
4648,MLM-BICYCLE_WRENCHES,7,9,0,413163,100%
4649,MLM-BASEBALL_AND_SOFTBALL_BALLS,24,25,0,413163,100%
4650,MLB-PLASTIC_INJECTION_MOLDS,4,5,0,413163,100%
4651,MLM-TAG_PINS,4,3,0,413163,100%
4653,MLM-MANUAL_STAPLERS_AND_BRAD_NAILERS,1,1,0,413163,100%
4654,MLM-QUAILS,2,2,0,413163,100%
4656,MLM-FLOOR_CLOCKS,1,1,0,413163,100%
4657,MLM-HAZELNUT_CREAMS,5,14,0,413163,100%
4658,MLM-TOILET_LIGHTS,1,1,0,413163,100%
4660,MLB-REFRIGERATOR_AND_FREEZER_CONTROL_BOARDS,155,188,0,413163,100%
4662,MLB-BICYCLE_V_BRAKE_CALIPERS,25,18,0,413163,100%
4663,MLM-AIR_CONDITIONERS_COMPRESSORS,5,5,0,413163,100%
4664,MLM-ENGINE_COOLING_FAN_MOTORS,4,1,0,413163,100%
4669,MLM-INDUSTRIAL_BOILERS,3,2,0,413163,100%
4670,MLM-LUGGAGE_TAGS,6,1,0,413163,100%
4679,MLB-MEDICAL_EQUIPMENT,158,202,0,413163,100%
4682,MLM-INFLATABLE_SOFAS,3,6,0,413163,100%
4683,MLM-EROTIC_VAGINAL_DILATORS,1,3,0,413163,100%
4685,MLM-TOUCHPADS,3,2,0,413163,100%
4687,MLM-COMBUSTION_OUTBOARD_MOTORS,4,3,0,413163,100%
4688,MLM-CRIMINALISTIC_KITS,8,10,0,413163,100%
4689,MLB-SCULPTURED_NAIL_REMOVER_CLIPS,9,5,0,413163,100%
4693,MLB-ESTHETIC_ELECTRIC_DEVICES,21,24,0,413163,100%
4696,MLB-CAMERA_FIELD_MONITORS,32,41,0,413163,100%
4697,MLM-TV_TUNERS,11,13,0,413163,100%
4698,MLM-AUTOMOTIVE_STEREO_CAGES,1,1,0,413163,100%
4700,MLM-PLANES,8,8,0,413163,100%
4703,MLM-AXES,9,2,0,413163,100%
4704,MLM-GATEWAYS,2,3,0,413163,100%
4705,MLM-SPARKLING_WINES,10,12,0,413163,100%
4706,MLB-FOOD_AND_DRINK_COLORINGS,49,71,0,413163,100%
4707,MLM-NETWORK_CABLE_TESTERS,6,7,0,413163,100%
4708,MLB-ACCORDIONS,294,429,0,413163,100%
4709,MLM-MOTORCYCLE_FILTER_KITS,2,3,0,413163,100%
4710,MLM-BICYCLE_REAR_DERAILLEURS,7,10,0,413163,100%
4711,MLB-BUOYANCY_COMPENSATORS,9,18,0,413163,100%
4712,MLM-ELECTRODE_HOLDERS,5,1,0,413163,100%
4713,MLM-MIRROR_AND_PAINTING_FRAMES,4,4,0,413163,100%
4714,MLB-CAR_AC_HOSE_ASSEMBLIES,105,122,0,413163,100%
4716,MLM-MATTOCKS,2,1,0,413163,100%
4717,MLM-SIDEBOARDS,8,10,0,413163,100%
4719,MLB-TANDEM_CHAIRS,46,91,0,413163,100%
4720,MLB-MODEL_SPACE_ROCKETS,4,5,0,413163,100%
4721,MLM-KITCHEN_TOWELS,5,5,0,413163,100%
4723,MLB-CONFETTI_SHOOTERS,12,18,0,413163,100%
4724,MLB-TRACTORS,217,432,0,413163,100%
4725,MLB-ARTISTIC_ACRYLIC_PAINTS,196,275,0,413163,100%
4728,MLM-FEELER_GAUGES,4,4,0,413163,100%
4729,MLB-BEDROOM_SETS,212,327,0,413163,100%
4730,MLM-DRUM_BRAKE_SHOES,13,9,0,413163,100%
4731,MLB-BUTTON_FOOTBALL_BUTTONS,94,108,0,413163,100%
4736,MLM-GYMNASTIC_RINGS,3,1,0,413163,100%
4737,MLB-BRAKE_MASTER_CYLINDERS,218,240,0,413163,100%
4739,MLM-PLAYGROUND_SLIDES,9,12,0,413163,100%
4740,MLM-HABERDASHERY_BEADS,14,34,0,413163,100%
4741,MLM-OUTLET_PLUG_COVERS,5,4,0,413163,100%
4742,MLM-WHEEL_STUDS,6,3,0,413163,100%
4743,MLM-NASAL_CPAP_MASKS,3,7,0,413163,100%
4744,MLB-FEMALE_URINATION_DEVICES,34,64,0,413163,100%
4745,MLM-ELECTRIC_HOISTS,7,11,0,413163,100%
4746,MLM-LIVESTOCK_FEEDERS,8,23,0,413163,100%
4748,MLM-GLASS_CUTTERS,11,15,0,413163,100%
4749,MLM-HAIRDRESSING_CAPS,2,3,0,413163,100%
4750,MLM-ENGINE_COOLING_FAN_SHROUDS,1,7,0,413163,100%
4751,MLB-LASER_CUTTING_AND_ENGRAVING_MACHINES,30,59,0,413163,100%
4753,MLB-SCAFFOLDS,69,149,0,413163,100%
4754,MLM-HEEL_CUPS,13,13,0,413163,100%
4755,MLB-CLARINETS,91,96,0,413163,100%
4756,MLB-PEDAL_EFFECTS,429,489,0,413163,100%
4757,MLB-MOTORCYCLE_WHEEL_SPOKES,228,319,0,413163,100%
4758,MLM-PAINT_MIXERS,4,3,0,413163,100%
4759,MLM-ROTATING_TOOLS_POLISHING_BRUSHES,7,13,0,413163,100%
4760,MLB-CAR_CENTER_CONSOLES,217,207,0,413163,100%
4763,MLM-VEGETABLES_AND_FRUITS,3,13,0,413163,100%
4764,MLM-GROUND_RESISTANCE_METERS,1,0,0,413163,100%
4765,MLB-OXYGEN_TANKS,14,17,0,413163,100%
4766,MLM-MANUAL_BROCHETTE_MAKERS,1,0,0,413163,100%
4767,MLM-SKATEBOARD_TRUCKS,10,9,0,413163,100%
4769,MLB-AIR_CONDITIONER_VALVES,3,4,0,413163,100%
4770,MLM-DRILLING_RIGS,2,2,0,413163,100%
4772,MLB-PARTY_DECORATIVE_BACKDROPS,87,142,0,413163,100%
4773,MLM-STORAGE_WATER_HEATERS,4,8,0,413163,100%
4774,MLM-MATE_STRAWS,2,0,0,413163,100%
4775,MLM-WINE_AERATORS,4,5,0,413163,100%
4777,MLB-TANK_DRUMS,7,4,0,413163,100%
4778,MLM-DIAPER_ORGANIZERS,2,1,0,413163,100%
4779,MLB-CORN_KERNELS,29,37,0,413163,100%
4780,MLM-FIBER_OPTIC_CLEANERS,2,3,0,413163,100%
4781,MLM-HOME_AND_OFFICE_FOOTRESTS,6,3,0,413163,100%
4782,MLM-AUTOMOTIVE_BRAKE_CALIPER_COVERS,6,8,0,413163,100%
4783,MLB-KEYBOARD_CONTROLLERS,216,252,0,413163,100%
4786,MLB-AUTOMOTIVE_LIGHTERS,21,34,0,413163,100%
4788,MLB-EROTIC_MOVIES,151,290,0,413163,100%
4790,MLB-GREEN_WALLS_AND_LIVING_PAINTINGS,111,251,0,413163,100%
4792,MLB-MOTORCYCLE_GEARBOXES,47,51,0,413163,100%
4793,MLM-ULTRASONIC_CLEANERS,1,0,0,413163,100%
4795,MLB-YERBA_MATE,8,5,0,413163,100%
4796,MLM-ALARM_REMOTE_CONTROLS,1,1,0,413163,100%
4800,MLB-PAPER_SHREDDERS,53,90,0,413163,100%
4801,MLM-KITCHEN_POTHOLDERS_AND_OVEN_MITTS,4,1,0,413163,100%
4802,MLM-BODYBOARDS,1,1,0,413163,100%
4803,MLM-SORE_THROAT_MEDICINES,7,7,0,413163,100%
4804,MLM-CYCLING_SETS,9,4,0,413163,100%
4806,MLM-LEARNING_TOY_LAPTOPS,10,15,0,413163,100%
4807,MLB-DRYWALLS,27,67,0,413163,100%
4809,MLB-PEDOMETERS,57,86,0,413163,100%
4812,MLB-PET_BEDDINGS,4,3,0,413163,100%
4813,MLM-BICYCLE_CHAINS,3,5,0,413163,100%
4814,MLB-FLOOR_PAINTS,34,81,0,413163,100%
4815,MLM-CNC_MILLING_MACHINES,2,4,0,413163,100%
4817,MLB-EVENT_TICKETS,66,80,0,413163,100%
4818,MLB-SEX_TOY_KITS,63,95,0,413163,100%
4819,MLM-MEDICAL_INSTRUMENT_TABLES,10,4,0,413163,100%
4820,MLM-CAR_AC_RECEIVER_DRIERS,2,2,0,413163,100%
4821,MLB-CABLE_ORGANIZER_BAGS,21,30,0,413163,100%
4824,MLB-LANYARDS,26,38,0,413163,100%
4825,MLB-AMERICAN_FOOTBALL_HELMETS,26,43,0,413163,100%
4830,MLB-MODEL_AIRCRAFT_PLANES,208,337,0,413163,100%
4831,MLM-HENTAI_MANGA,8,10,0,413163,100%
4832,MLB-ALL_IN_ONE,242,298,0,413163,100%
4834,MLB-MILK_CHILLERS,15,25,0,413163,100%
4835,MLM-AUTOMOTIVE_FUSE_BOX_COVERS,3,1,0,413163,100%
4836,MLB-NEWTONS_CRADLES,20,35,0,413163,100%
4837,MLB-MOTORCYCLE_AIR_FILTER_BOXES,51,59,0,413163,100%
4840,MLB-PEDALBOARDS,73,85,0,413163,100%
4842,MLM-PHOTOGRAPHIC_STUDIO_FLASHES,2,1,0,413163,100%
4844,MLB-MODEL_AIRCRAFT_PROPELLERS,53,42,0,413163,100%
4845,MLM-MANICURE_AND_PEDICURE_FINGER_SEPARATORS,3,2,0,413163,100%
4848,MLM-BABY_NESTS,4,3,0,413163,100%
4849,MLB-AUTOMOTIVE_AC_PANEL_KNOBS,91,81,0,413163,100%
4854,MLB-EROTIC_MASSAGE_OILS,103,125,0,413163,100%
4856,MLB-STONE_FLOORINGS,97,216,0,413163,100%
4860,MLB-FISHING_ROD_CASES,38,43,0,413163,100%
4861,MLB-TOY_KITES,43,81,0,413163,100%
4862,MLM-CONDENSED_MILK,3,4,0,413163,100%
4863,MLB-ENGINE_CRANKSHAFT_PULLEYS,218,188,0,413163,100%
4865,MLB-KITCHEN_TOWEL_RACKS,26,36,0,413163,100%
4867,MLM-MOTORCYCLE_HANDLEBAR_YOKES,4,4,0,413163,100%
4868,MLM-DRAWING_AND_SKETCH_PADS,2,1,0,413163,100%
4870,MLB-PADS,46,53,0,413163,100%
4872,MLB-BEDLINERS,59,82,0,413163,100%
4873,MLM-TRAILER_HITCH_BALLS,3,4,0,413163,100%
4874,MLB-TREADMILL_RUNNING_BELTS,50,44,0,413163,100%
4875,MLM-PET_RAINCOATS,7,10,0,413163,100%
4879,MLB-MEASURING_SPOONS,59,88,0,413163,100%
4881,MLM-HYGIENIC_WET_WIPES,6,3,0,413163,100%
4882,MLM-BICYCLE_BOTTOM_BRACKETS,11,9,0,413163,100%
4883,MLB-TACTICAL_GLOVES,14,13,0,413163,100%
4884,MLM-CHESS_CLOCKS,4,4,0,413163,100%
4885,MLB-COOKING_TORCHES,25,29,0,413163,100%
4886,MLM-HABERDASHERY_LACE_EDGINGS,4,6,0,413163,100%
4888,MLB-RODENT_DRINKERS_AND_FEEDERS,19,26,0,413163,100%
4889,MLM-INVISIBLE_PET_FENCES,1,1,0,413163,100%
4892,MLB-MANUAL_OIL_CANS,6,5,0,413163,100%
4893,MLB-ENGINE_OIL_PAN_GASKET_SETS,36,32,0,413163,100%
4895,MLM-JAMS,3,3,0,413163,100%
4896,MLM-DECORATIVE_AND_PROMOTIONAL_MAGNETS,11,19,0,413163,100%
4897,MLM-ENGINE_OIL_PAN_GASKET_SETS,9,8,0,413163,100%
4898,MLM-WASHING_AND_DRYER_MACHINE_BELTS,6,8,0,413163,100%
4900,MLB-EMBROIDERY_FRAMES,20,30,0,413163,100%
4904,MLB-TELEPHONY_CARDS,19,15,0,413163,100%
4905,MLB-HANDBAG_HOOKS,8,10,0,413163,100%
4906,MLM-BURETTES,3,0,0,413163,100%
4907,MLM-HOME_HEATERS,7,9,0,413163,100%
4908,MLM-ENERGETIC_STONES,4,2,0,413163,100%
4909,MLM-WELDING_CHIPPING_HAMMERS,1,1,0,413163,100%
4911,MLB-INDUSTRIAL_PULLEYS,120,147,0,413163,100%
4912,MLB-CEMENT_TILES,104,346,0,413163,100%
4914,MLM-VEHICLE_GAUGE_HOLDERS,6,10,0,413163,100%
4915,MLM-EXCAVATORS,5,8,0,413163,100%
4916,MLM-FIBER_OPTIC_SPLITTERS,2,2,0,413163,100%
4917,MLM-AUTOMOTIVE_STEERING_U_JOINTS,6,5,0,413163,100%
4918,MLB-CAR_INTERCOOLERS,56,54,0,413163,100%
4920,MLM-CALLER_ID_DEVICES,2,4,0,413163,100%
4922,MLM-VARNISHES,3,5,0,413163,100%
4923,MLB-LAPTOP_SKINS,90,209,0,413163,100%
4925,MLM-ENGINE_CYLINDER_HEAD_BOLTS,1,0,0,413163,100%
4927,MLM-ZIPPERS,3,3,0,413163,100%
4928,MLM-HOME_CLEANING_BRUSHES,12,17,0,413163,100%
4929,MLB-KIDS_WALKIE_TALKIES,43,104,0,413163,100%
4930,MLB-AUTOMOTIVE_PARKING_BRAKE_LEVER_BOOTS,15,10,0,413163,100%
4931,MLM-KITCHEN_WHEEL_CUTTERS,2,2,0,413163,100%
4932,MLM-AUTOMOTIVE_STEERING_WHEEL_LOCKS,9,9,0,413163,100%
4933,MLM-BDSM_HANDCUFFS,7,13,0,413163,100%
4934,MLB-DRUMHEADS,152,351,0,413163,100%
4935,MLB-GYPSUM_BOARDS,82,272,0,413163,100%
4937,MLM-CONSTRUCTION_BEAMS,4,7,0,413163,100%
4940,MLB-BODYBOARDS,54,104,0,413163,100%
4941,MLM-BASKETBALL_NETS,2,2,0,413163,100%
4943,MLB-DIFFERENTIALS,120,194,0,413163,100%
4945,MLM-INTERDENTAL_BRUSHES,3,2,0,413163,100%
4946,MLM-AUTOMOTIVE_FUSE_BOXES,6,11,0,413163,100%
4947,MLM-VEHICLE_TIRE_VALVE_CAPS,7,7,0,413163,100%
4948,MLB-BICYCLE_WHEELS,415,661,0,413163,100%
4950,MLB-BICYCLE_DISC_BRAKE_PADS,61,83,0,413163,100%
4951,MLM-HARD_DRIVE_AND_SSD_DOCKING_STATIONS,3,0,0,413163,100%
4952,MLB-BICYCLE_SHOCK_ABSORBERS,49,92,0,413163,100%
4953,MLB-OFFICE_CUBICLES,41,66,0,413163,100%
4955,MLB-CARPET_AND_UPHOLSTERY_CLEANERS,20,38,0,413163,100%
4957,MLB-DOG_AND_CAT_BLANKETS,32,41,0,413163,100%
4958,MLM-CORDLESS_TELEPHONE_BATTERIES,6,12,0,413163,100%
4959,MLM-BICYCLE_TRAINING_WHEELS,1,1,0,413163,100%
4960,MLM-CIGARETTE_VENDING_MACHINES,6,10,0,413163,100%
4961,MLM-AIR_HOCKEY_TABLES,2,4,0,413163,100%
4962,MLM-STRING_INSTRUMENT_STANDS_AND_WALL_HANGERS,20,25,0,413163,100%
4963,MLM-MUSIC_MOVIES_AND_TV_SERIES,11,13,0,413163,100%
4964,MLM-HOUSEHOLD_CLEANING_WET_WIPES,3,1,0,413163,100%
4965,MLM-ELBOW_SUPPORTS,1,1,0,413163,100%
4966,MLM-AYRE_SCRAPERS,10,14,0,413163,100%
4967,MLM-MOTORCYCLE_BENDIX_STARTERS,4,4,0,413163,100%
4968,MLB-ANTI_STATIC_SMOCKS,8,8,0,413163,100%
4971,MLB-GONDOLA_SHELVING_UNITS,139,217,0,413163,100%
4972,MLB-BACKWASH_UNITS,160,360,0,413163,100%
4973,MLM-AQUARIUM_GRAVEL_CLEANERS,1,0,0,413163,100%
4974,MLB-BICYCLE_WHEEL_HUB_SKEWERS,29,21,0,413163,100%
4975,MLB-PUSH_BUTTONS,18,7,0,413163,100%
4976,MLB-GREASE_TRAPS,57,161,0,413163,100%
4978,MLM-HABERDASHERY_HOOK_AND_LOOP_FASTENERS,3,1,0,413163,100%
4979,MLM-FUEL_INJECTION_PIPES,3,2,0,413163,100%
4981,MLB-AUTOMOTIVE_OBD_CABLE_ADAPTERS,32,60,0,413163,100%
4983,MLB-KITES,43,46,0,413163,100%
4985,MLB-BEACH_TOYS_SETS,95,90,0,413163,100%
4986,MLM-BICYCLE_SEAT_POSTS,11,5,0,413163,100%
4987,MLB-ASHTRAYS,48,62,0,413163,100%
4988,MLB-AUTOMOTIVE_SHOCK_ABSORBER_KITS,144,179,0,413163,100%
4989,MLM-ELECTRIC_FLOAT_SWITCHES,4,3,0,413163,100%
4990,MLB-BAG_DISPENSERS,45,70,0,413163,100%
4992,MLB-LADLES,86,107,0,413163,100%
4995,MLB-PHOTOGRAPHIC_MINILABS,12,16,0,413163,100%
4996,MLB-MOTORCYCLE_OIL_PUMPS,42,56,0,413163,100%
4997,MLM-THERMAL_TAPES,11,14,0,413163,100%
4999,MLM-SMOKER_OVENS,4,6,0,413163,100%
5000,MLM-BAKING_POWDERS,3,2,0,413163,100%
5003,MLM-HANDLOOMS,1,2,0,413163,100%
5004,MLM-VEHICLE_CYLINDER_LINERS,4,5,0,413163,100%
5005,MLM-STACKABLE_BINS,1,0,0,413163,100%
5006,MLM-HEAT_SINKS,8,15,0,413163,100%
5007,MLM-SHOOTING_STICKS,2,4,0,413163,100%
5011,MLM-BOX_SPRING_AND_MATTRESS_SETS,7,3,0,413163,100%
5012,MLM-STRAIGHT_PINS,1,1,0,413163,100%
5014,MLM-PARAFFIN_BATHS,2,3,0,413163,100%
5015,MLB-PINBALLS,33,48,0,413163,100%
5016,MLB-MOTORCYCLE_AND_ALL_TERRAIN_VEHICLE_CARGO_NETS,44,43,0,413163,100%
5021,MLB-GLAZED_DISPLAY_CABINETS,266,447,0,413163,100%
5022,MLB-PDA_BATTERIES,7,5,0,413163,100%
5024,MLB-SPORT_WEIGHT_VESTS,18,37,0,413163,100%
5025,MLM-AQUARIUM_AUTOMATIC_FEEDERS,3,3,0,413163,100%
5026,MLM-MODEL_NAVAL_BOATS,9,15,0,413163,100%
5027,MLM-MANUAL_SAUSAGE_STUFFERS,3,4,0,413163,100%
5028,MLB-FENCING_PLIERS,19,21,0,413163,100%
5029,MLB-ENGINE_INTAKE_MANIFOLDS,140,132,0,413163,100%
5030,MLM-EXTERNAL_BREAST_PROSTHESES,10,18,0,413163,100%
5031,MLM-ANTI_STATIC_PLIERS,4,4,0,413163,100%
5032,MLM-MINI_PHOTO_STUDIOS,8,13,0,413163,100%
5033,MLB-HOUSE_FENCES,34,52,0,413163,100%
5035,MLB-BICYCLE_HANDLEBAR_TAPES,10,15,0,413163,100%
5036,MLM-PERCUSSION_CASES_AND_BAGS,4,5,0,413163,100%
5038,MLB-PAIN_RELIEF_MEDICINES,6,4,0,413163,100%
5040,MLM-SEX_TOY_CLEANERS,1,1,0,413163,100%
5042,MLM-OFFICE_CUBICLES,4,13,0,413163,100%
5044,MLB-COLD_ROOMS,73,122,0,413163,100%
5052,MLB-DENTAL_FLOSSES,24,12,0,413163,100%
5055,MLB-AUTOMOTIVE_AIR_FILTER_BOXES,30,40,0,413163,100%
5056,MLB-MOTORCYCLE_CLUTCH_BELLS,39,40,0,413163,100%
5059,MLB-FLOOR_MAKER_MOLDS,68,101,0,413163,100%
5060,MLB-AUTOMOTIVE_AIR_INTAKE_SNORKELS,13,15,0,413163,100%
5061,MLB-DEVELOPMENT_APARTMENTS_FOR_SALE,38,86,0,413163,100%
5062,MLM-PUSH_AND_RIDING_TOYS,15,48,0,413163,100%
5066,MLB-HYDROPHILIC_COTTON,45,29,0,413163,100%
5067,MLB-BICYCLE_CASSETTES,387,640,0,413163,100%
5068,MLM-DIVING_COMPUTERS,3,2,0,413163,100%
5069,MLM-BIRD_SPIKES,9,15,0,413163,100%
5070,MLB-CRANKSHAFTS,112,109,0,413163,100%
5072,MLB-CATHETERS,32,48,0,413163,100%
5073,MLB-SOFT_DRINKS,66,79,0,413163,100%
5074,MLB-MARTIAL_ARTS_CHEST_GUARDS,20,32,0,413163,100%
5075,MLB-HEATING_PADS,34,55,0,413163,100%
5076,MLB-HUMAN_ORGAN_ANATOMICAL_MODELS,22,25,0,413163,100%
5079,MLM-PHOTOCOPIER_LAMPS,1,2,0,413163,100%
5080,MLB-ANTIQUE_TELEVISIONS,43,46,0,413163,100%
5083,MLB-COASTERS,88,169,0,413163,100%
5085,MLB-PAINTBALL_MARKER_MAGAZINES,27,34,0,413163,100%
5086,MLB-LCD_DISPLAYS,312,424,0,413163,100%
5087,MLB-TOY_IRONS,14,11,0,413163,100%
5088,MLM-LAPTOP_REPLACEMENT_TOUCHPADS,7,9,0,413163,100%
5089,MLB-FARM_HOUSES_FOR_VACATION_RENTAL,94,193,0,413163,100%
5090,MLM-ARCADE_STICK_CASES,6,12,0,413163,100%
5091,MLB-TRASH_BAGS,4,8,0,413163,100%
5094,MLB-PRINTER_TIMING_BELTS,19,15,0,413163,100%
5095,MLM-DOG_POOP_BAGS,10,23,0,413163,100%
5096,MLM-HOSE_HOLDERS,1,1,0,413163,100%
5100,MLB-AUTOMOTIVE_MANUAL_WINDOW_REGULATOR_SYSTEMS,92,94,0,413163,100%
5105,MLM-CUTTING_PLOTTER_BLADES,2,0,0,413163,100%
5106,MLB-FIBER_OPTIC_SPLITTERS,52,54,0,413163,100%
5108,MLM-SHOWER_CURTAIN_HOOKS,3,3,0,413163,100%
5109,MLB-BABY_WELCOME_SIGNS,55,73,0,413163,100%
5110,MLB-WAREHOUSES_FOR_RENT,90,99,0,413163,100%
5111,MLB-HOOD_HINGES,22,27,0,413163,100%
5112,MLB-VEHICLE_KILL_SWITCH_KEYS,17,11,0,413163,100%
5114,MLB-GUITAR_PICKS,102,123,0,413163,100%
5115,MLB-CAKE_COVER_PASTES,11,9,0,413163,100%
5118,MLB-WASHING_MACHINE_PRESSURE_SWITCHES,65,75,0,413163,100%
5119,MLB-FIBER_OPTIC_SPLICE_PROTECTION_SLEEVES,14,4,0,413163,100%
5121,MLM-FOOD_DEHYDRATORS,18,24,0,413163,100%
5130,MLM-AUTOMOTIVE_TRIPOD_JOINT_SPIDERS,4,3,0,413163,100%
5132,MLB-MANICURE_AND_PEDICURE_KITS,72,147,0,413163,100%
5133,MLB-FLOOR_DEODORIZERS,12,21,0,413163,100%
5136,MLM-SCULPTURED_NAIL_FORMS,11,8,0,413163,100%
5137,MLM-TATTOO_AFTERCARE_CREAMS,6,7,0,413163,100%
5138,MLM-HORSE_BLANKETS,1,0,0,413163,100%
5139,MLM-SNACK_HOLDERS,3,1,0,413163,100%
5140,MLB-DJ_CASES,117,156,0,413163,100%
5141,MLB-AUTOMOTIVE_CROSSMEMBERS,35,45,0,413163,100%
5142,MLB-DJ_MIXERS,93,92,0,413163,100%
5144,MLB-AUTOMOTIVE_DASHBOARDS,140,182,0,413163,100%
5145,MLB-COMPACTORS,6,4,0,413163,100%
5147,MLM-PIPE_INSULATIONS,3,3,0,413163,100%
5149,MLB-COLLECTIBLE_ALBUM_STICKERS,114,104,0,413163,100%
5150,MLB-MEAT_BAND_SAWS,49,72,0,413163,100%
5152,MLM-WASHING_MACHINE_SHOCK_ABSORBERS,4,7,0,413163,100%
5153,MLB-DECORATIVE_PANELS,129,278,0,413163,100%
5154,MLB-TOY_KITE_STICKS,7,5,0,413163,100%
5157,MLB-DRINKING_GLASS_AND_MUG_IDENTIFIERS,3,4,0,413163,100%
5158,MLB-HABERDASHERY_BUTTONS,94,178,0,413163,100%
5162,MLM-AUTOMOTIVE_NITROUS_OXIDE_SYSTEMS,1,1,0,413163,100%
5165,MLB-AMERICAN_FOOTBALL_BALLS,30,42,0,413163,100%
5167,MLB-STRAIGHT_PINS,12,22,0,413163,100%
5168,MLB-FILE_BOXES,33,37,0,413163,100%
5171,MLM-VIOLIN_AND_VIOLA_STRINGS,6,8,0,413163,100%
5172,MLM-ARTIFICIAL_FEATHERS,6,18,0,413163,100%
5173,MLM-BROCHURES,1,3,0,413163,100%
5174,MLM-RISER_CARDS,3,4,0,413163,100%
5175,MLB-RIDING_STIRRUPS,33,41,0,413163,100%
5176,MLB-SAXOPHONES,328,476,0,413163,100%
5177,MLM-COIN_COUNTERS,3,2,0,413163,100%
5178,MLB-TATTOO_NEEDLE_CARTRIDGES,47,63,0,413163,100%
5179,MLM-PLANTING_KITS,12,13,0,413163,100%
5180,MLB-VEHICLE_BRAKE_HYDRAULIC_HOSES,53,62,0,413163,100%
5185,MLB-AUTOMOTIVE_PROGRAMMABLE_EMS,22,33,0,413163,100%
5186,MLB-CAR_DOOR_HINGES,80,91,0,413163,100%
5187,MLB-WATER_DISPENSER_HOSES,55,63,0,413163,100%
5189,MLM-BICYCLE_SHOCK_ABSORBERS,7,23,0,413163,100%
5191,MLM-HOSE_REELS,2,2,0,413163,100%
5192,MLB-KITCHEN_TIMERS,35,42,0,413163,100%
5193,MLB-TRIVETS,33,49,0,413163,100%
5194,MLM-GINGER,9,6,0,413163,100%
5195,MLB-SECURITY_SPIKES,40,114,0,413163,100%
5196,MLB-LANDS_FOR_RENT,7,4,0,413163,100%
5201,MLB-CLOTHING_RACKS,79,137,0,413163,100%
5204,MLM-HYDRAULIC_PRESSES,6,5,0,413163,100%
5209,MLB-PRESSOTHERAPY_MACHINES,7,10,0,413163,100%
5210,MLM-DOOR_HYDRAULIC_ARMS,2,0,0,413163,100%
5211,MLM-BATHROOM_GRAB_BARS,6,15,0,413163,100%
5212,MLM-STAPLERS,10,10,0,413163,100%
5213,MLM-GAME_CONSOLE_LASER_LENSES,9,7,0,413163,100%
5214,MLM-DIGITAL_PIANOS,3,2,0,413163,100%
5215,MLM-HOES,4,8,0,413163,100%
5216,MLM-CAMERA_AND_VIDEO_CAMERA_BAGS_AND_CASES,2,0,0,413163,100%
5217,MLM-KNITTING_NEEDLES,8,11,0,413163,100%
5218,MLM-NETWORK_PLUGS,12,51,0,413163,100%
5219,MLB-PLANT_POT_STANDS,26,27,0,413163,100%
5221,MLM-HUMAN_ORGAN_ANATOMICAL_MODELS,15,26,0,413163,100%
5222,MLM-FUEL_INJECTION_RAILS,4,3,0,413163,100%
5224,MLM-BALANCE_DISCS_AND_HALF_BALLS,1,2,0,413163,100%
5226,MLM-COLD_PORCELAIN_CLAYS,4,6,0,413163,100%
5227,MLB-LICE_COMBS,30,53,0,413163,100%
5229,MLM-TIMERS,11,9,0,413163,100%
5230,MLM-SWIMMING_KICKBOARDS,6,10,0,413163,100%
5231,MLB-KEYBOARD_AND_PIANO_BENCHES,20,22,0,413163,100%
5233,MLM-ANTIFUNGAL_MEDICINES,2,3,0,413163,100%
5236,MLB-HONEY,129,163,0,413163,100%
5239,MLM-AUTOMOTIVE_ALARM_KITS,3,8,0,413163,100%
5241,MLB-AXES,94,128,0,413163,100%
5242,MLB-FISHING_GLOVES_AND_MITTENS,55,76,0,413163,100%
5243,MLM-OPTICAL_LEVELS,3,3,0,413163,100%
5244,MLB-MOTORCYCLE_OIL_FILTERS,130,182,0,413163,100%
5245,MLM-AQUARIUM_SALTS,3,1,0,413163,100%
5248,MLM-COMPUTER_PRIVACY_SCREENS,4,3,0,413163,100%
5250,MLB-MOTORCYCLE_LIGHT_SWITCHES,146,213,0,413163,100%
5251,MLM-POTATO_MASHERS,3,18,0,413163,100%
5252,MLB-TROPHIES,138,223,0,413163,100%
5253,MLB-SANDBLASTERS,27,65,0,413163,100%
5254,MLM-CAR_QUARTER_GLASSES,4,4,0,413163,100%
5259,MLB-AUTOMOTIVE_CLIPS,85,96,0,413163,100%
5260,MLB-ARCADE_STICK_CASES,34,72,0,413163,100%
5261,MLB-PERCUSSION_CASES_AND_BAGS,110,170,0,413163,100%
5262,MLM-PEANUT_BUTTERS,5,9,0,413163,100%
5263,MLB-MOUTHWASHES,24,24,0,413163,100%
5264,MLB-WASHING_MACHINE_PULLEYS,42,76,0,413163,100%
5265,MLM-CONFETTI_MACHINES,1,1,0,413163,100%
5266,MLM-AUTOMOTIVE_TOW_STRAPS,3,3,0,413163,100%
5267,MLM-MOTORCYCLE_STARTER_MOTORS,2,1,0,413163,100%
5268,MLM-FOLDER_DIVIDERS,1,1,0,413163,100%
5269,MLM-PRINTER_POWER_SUPPLIES,4,6,0,413163,100%
5270,MLB-SHAPER_AND_MILLING_MACHINES,77,75,0,413163,100%
5271,MLB-BERRANTES,5,10,0,413163,100%
5274,MLM-MUSICAL_KEYBOARD_RUBBER_CONTACTS,1,1,0,413163,100%
5275,MLB-DRONE_BACKPACKS_AND_CASES,21,28,0,413163,100%
5276,MLB-CAR_TINTED_GLASSES,53,67,0,413163,100%
5278,MLM-BICYCLE_BASKETS,8,4,0,413163,100%
5280,MLB-EAR_TAG_APPLICATORS,10,12,0,413163,100%
5282,MLM-UNDERPLATES,6,9,0,413163,100%
5284,MLB-NEOPRENE_HOODS,9,7,0,413163,100%
5285,MLB-EROTIC_PANTIES,14,43,0,413163,100%
5286,MLM-STRAPPING_MACHINES_AND_TENSIONERS,3,3,0,413163,100%
5287,MLM-TRAINING_BIBS,4,3,0,413163,100%
5288,MLM-COLD_CUTS_AND_CASINGS,1,0,0,413163,100%
5290,MLM-BICYCLE_BRAKE_AND_SHIFTER_CABLES,2,3,0,413163,100%
5291,MLM-ELECTRIC_MEAT_MIXERS,7,1,0,413163,100%
5292,MLM-TOILET_DEODORIZERS,7,5,0,413163,100%
5294,MLB-SIM_CARD_EJECT_PINS,9,7,0,413163,100%
5301,MLM-DOG_AND_CAT_SANITARY_PANTIES,2,2,0,413163,100%
5303,MLB-PHOTOGRAPHS,42,35,0,413163,100%
5304,MLB-TABLE_RUNNERS,128,158,0,413163,100%
5305,MLB-DRUM_BRAKE_WHEEL_CYLINDERS,61,55,0,413163,100%
5308,MLB-SUTURE_THREADS,27,56,0,413163,100%
5309,MLM-MODEL_AIRCRAFT_PROPELLERS,5,0,0,413163,100%
5311,MLB-SWEDISH_BARS,10,13,0,413163,100%
5312,MLM-BICYCLE_DISC_BRAKE_ADAPTERS,2,3,0,413163,100%
5315,MLB-SEASONINGS,62,60,0,413163,100%
5316,MLB-CAT_LITTER_BOXES,86,156,0,413163,100%
5320,MLM-SPORT_PROTECTION_ELBOW_PADS,12,9,0,413163,100%
5321,MLM-STEEL_SCRAPERS,5,6,0,413163,100%
5322,MLM-VIDEO_CASSETTES,3,3,0,413163,100%
5323,MLM-SQUISHIES,19,18,0,413163,100%
5324,MLM-POWER_TROWELS,2,2,0,413163,100%
5325,MLM-TACTICAL_JACKETS,3,6,0,413163,100%
5326,MLM-STADIOMETERS,2,4,0,413163,100%
5327,MLM-TURNBUCKLES,4,9,0,413163,100%
5328,MLM-HONEY_SPOONS,2,3,0,413163,100%
5330,MLB-NAUTICAL_PROPELLERS,112,181,0,413163,100%
5331,MLB-AUTOMOTIVE_FLOOR_PANS,129,212,0,413163,100%
5332,MLM-BABY_FOODS,2,4,0,413163,100%
5333,MLM-KIDS_FAUCET_EXTENDERS,1,0,0,413163,100%
5334,MLB-MOTORCYCLE_MAGNETO_ROTORS,52,72,0,413163,100%
5336,MLB-FUEL_INJECTION_PIPES,13,13,0,413163,100%
5338,MLB-CONDENSED_MILK,41,72,0,413163,100%
5339,MLM-GOJI_BERRIES,5,6,0,413163,100%
5340,MLB-CONSTRUCTION_BEAMS,28,32,0,413163,100%
5341,MLB-EXTRUSION_MACHINES,38,46,0,413163,100%
5342,MLB-WORLD_GLOBES,53,51,0,413163,100%
5344,MLB-GYMNASTIC_AND_PILATES_HOOPS,3,5,0,413163,100%
5345,MLB-KITCHEN_FORKS,40,74,0,413163,100%
5346,MLM-TEXTILE_ELASTICS,3,3,0,413163,100%
5347,MLM-BEAM_AND_JOIST_BRACKETS,3,5,0,413163,100%
5348,MLM-DRONE_PROPELLER_GUARDS,2,3,0,413163,100%
5349,MLB-MUSICAL_ORGANS,46,65,0,413163,100%
5351,MLB-EYELASH_CURLERS,46,71,0,413163,100%
5354,MLM-AUTOMOTIVE_AIR_FILTER_BOXES,2,3,0,413163,100%
5355,MLB-AUTOMOTIVE_STEERING_U_JOINTS,22,19,0,413163,100%
5358,MLB-NAUTICAL_CANOPIES,45,57,0,413163,100%
5360,MLM-DIVING_BELTS,1,1,0,413163,100%
5361,MLM-MINING_RIGS,2,8,0,413163,100%
5362,MLB-GAME_CONSOLE_COOLERS,32,41,0,413163,100%
5366,MLB-CLIMBING_HARNESSES,48,67,0,413163,100%
5367,MLM-CPU_HOLDERS,4,3,0,413163,100%
5372,MLB-PONCHOS,72,86,0,413163,100%
5373,MLB-WALL_ANCHOR_PLUGS,143,194,0,413163,100%
5374,MLM-CAKE_LEVELERS,13,20,0,413163,100%
5375,MLM-HYDROPHILIC_COTTON,2,1,0,413163,100%
5376,MLB-AYRE_SCRAPERS,1,2,0,413163,100%
5377,MLB-WELDING_BLOWTORCHES,62,85,0,413163,100%
5378,MLM-MOTORCYCLE_SPOKE_COVERS,2,3,0,413163,100%
5379,MLM-AUTOMOTIVE_BLOWER_HEATER_MOTORS,2,4,0,413163,100%
5380,MLM-FOLDER_AND_EXPANDING_FILE_FILLER_PAPERS,2,3,0,413163,100%
5381,MLB-IGNITION_CONTROL_MODULES,150,186,0,413163,100%
5385,MLB-NEGATOSCOPES,18,34,0,413163,100%
5388,MLM-CAMPING_MESS_KITS,1,3,0,413163,100%
5389,MLM-CAR_AC_EXPANSION_VALVES,4,1,0,413163,100%
5390,MLM-COLLECTIBLE_CANS_AND_BOTTLES,1,1,0,413163,100%
5391,MLM-BICYCLE_STEMS,1,1,0,413163,100%
5394,MLB-DENTAL_CHAIRS,65,82,0,413163,100%
5397,MLB-LIP_GLOSSES,95,104,0,413163,100%
5399,MLM-SWEET_PREMIXES,1,2,0,413163,100%
5400,MLM-FACIAL_TISSUES,1,1,0,413163,100%
5402,MLM-QUEUE_STANCHIONS,1,1,0,413163,100%
5404,MLM-CONSTRUCTION_TILE_GROUTS,2,1,0,413163,100%
5405,MLB-TOY_KITE_HANDLES_AND_REELS,18,18,0,413163,100%
5406,MLM-AUTOMOTIVE_DISTRIBUTOR_PICKUP_COILS,1,0,0,413163,100%
5407,MLB-COFFEE_AND_FOOD_DECORATIVE_STENCILS,2,3,0,413163,100%
5408,MLB-BEER_BREWING_EQUIPMENTS,69,136,0,413163,100%
5409,MLM-CLEANING_AND_BATH_SPONGE_HOLDERS,3,7,0,413163,100%
5410,MLM-AUTOMOTIVE_MANUAL_TRANSMISSION_SHIFT_CABLES,3,2,0,413163,100%
5413,MLM-CAMERA_BATTERY_GRIPS,5,7,0,413163,100%
5414,MLM-FIBER_OPTIC_SPLICE_CLOSURES,1,1,0,413163,100%
5417,MLB-BLU_RAY_PLAYERS,61,95,0,413163,100%
5418,MLB-SPEAKER_GRILLS,129,131,0,413163,100%
5419,MLB-DISTRIBUTION_KITS,108,121,0,413163,100%
5421,MLB-BOLT_CUTTERS,29,57,0,413163,100%
5424,MLB-MEASURING_CUPS_AND_JUGS,22,25,0,413163,100%
5425,MLM-AUTOMOTIVE_TRASH_BAGS,1,0,0,413163,100%
5426,MLB-AUTOMOTIVE_TURN_SIGNAL_LIGHT_LENSES,69,64,0,413163,100%
5427,MLM-PREFABRICATED_FIBERGLASS_POOLS,4,13,0,413163,100%
5431,MLM-LENS_HOODS,5,9,0,413163,100%
5432,MLM-MOTORCYCLE_HANDLEBAR_PADS,10,17,0,413163,100%
5433,MLM-MOTORCYCLE_SUMP_GUARDS,1,1,0,413163,100%
5436,MLM-MOTORCYCLE_SPEEDOMETER_CABLES,4,5,0,413163,100%
5437,MLB-PLUMB_BOBS,21,12,0,413163,100%
5439,MLB-NURSING_PADS,36,46,0,413163,100%
5440,MLM-SUN_TANNER_PRODUCTS,4,4,0,413163,100%
5441,MLM-KITCHEN_BAKING_DISHES_AND_SHEETS,2,4,0,413163,100%
5444,MLM-BROOM_HOLDERS,5,14,0,413163,100%
5445,MLB-MILITARY_COLLECTIBLE_SUPPLIES,280,340,0,413163,100%
5448,MLB-KITCHEN_SPOONS,66,93,0,413163,100%
5450,MLM-PHOTOCONTROLS,4,2,0,413163,100%
5451,MLM-FURNITURE_LEGS,10,9,0,413163,100%
5452,MLM-MAGNETIC_THERAPY_MACHINES,3,3,0,413163,100%
5453,MLM-APPETIZER_PICKS,5,2,0,413163,100%
5457,MLM-DIGITAL_TIRE_GAUGES,1,1,0,413163,100%
5458,MLM-TOILET_BRUSHES,2,2,0,413163,100%
5459,MLM-ANTIQUE_CHAIRS,5,3,0,413163,100%
5460,MLB-NETWORK_CABLE_TESTERS,27,24,0,413163,100%
5461,MLB-GARDENING_AND_AGRICULTURE_SUBSTRATES,30,33,0,413163,100%
5462,MLB-AIR_CONDITIONERS_COMPRESSORS,31,41,0,413163,100%
5467,MLB-TV_TUNERS,35,34,0,413163,100%
5468,MLB-VEHICLE_BRAKE_FLUIDS,3,3,0,413163,100%
5469,MLB-MECHANICAL_PENCIL_LEADS,9,7,0,413163,100%
5471,MLB-HEMOSTATS,12,10,0,413163,100%
5473,MLB-EROTIC_PARTY_SUPPLIES,33,31,0,413163,100%
5475,MLM-BICYCLE_TRAINERS,7,2,0,413163,100%
5476,MLM-BREADS,5,1,0,413163,100%
5477,MLM-PHOTOGRAPHS,1,6,0,413163,100%
5478,MLM-CELLPHONE_REPLACEMENT_MICROPHONES,4,2,0,413163,100%
5479,MLM-TOY_VANITIES,6,16,0,413163,100%
5481,MLM-POTATO_PEELERS,1,1,0,413163,100%
5484,MLB-TACTICAL_POUCHES,55,107,0,413163,100%
5485,MLM-EYEBROW_STENCILS,4,8,0,413163,100%
5486,MLM-PRINTER_SUPPLIES_KITS,1,0,0,413163,100%
5487,MLM-PROTECTIVE_ADHESIVE_BANDAGES,3,1,0,413163,100%
5489,MLB-MOTORCYCLE_NECK_BRACES,25,46,0,413163,100%
5490,MLM-FLOATING_CHLORINE_DISPENSERS,2,0,0,413163,100%
5491,MLB-RETRO_EXCAVATORS,90,163,0,413163,100%
5492,MLB-POTATO_PEELERS,12,11,0,413163,100%
5493,MLB-SPEAKERS_STANDS,23,32,0,413163,100%
5495,MLB-PRINTER_POWER_SUPPLIES,53,74,0,413163,100%
5496,MLM-PRINTER_TRANSPARENCIES,5,5,0,413163,100%
5497,MLM-BICYCLE_TIRE_SEALANTS,4,4,0,413163,100%
5498,MLM-TONFA_AND_SELF_DEFENSE_BATON_HOLDERS,2,4,0,413163,100%
5499,MLB-MOTORCYCLE_BRAKE_CABLES,28,39,0,413163,100%
5500,MLM-SECURITY_MONITORS,1,2,0,413163,100%
5501,MLM-BABY_FOOD_DISPENSER_SPOONS,2,4,0,413163,100%
5502,MLB-FISHING_SPEARGUNS,88,181,0,413163,100%
5503,MLB-PATCH_PANELS,50,56,0,413163,100%
5504,MLM-CONSTRUCTION_GRAVELS,2,3,0,413163,100%
5505,MLB-AUTOMOTIVE_CRANKSHAFT_GEARS,15,13,0,413163,100%
5506,MLB-CALLER_ID_DEVICES,9,11,0,413163,100%
5507,MLM-PET_STAIRS_AND_RAMPS,3,1,0,413163,100%
5509,MLM-BATH_BOMBS,2,0,0,413163,100%
5510,MLM-OPHTHALMOSCOPES,1,1,0,413163,100%
5511,MLM-TABLE_SAWS,1,4,0,413163,100%
5512,MLM-LEG_WARMERS,5,11,0,413163,100%
5513,MLB-MODEL_RAILROADING_WAGONS,28,24,0,413163,100%
5514,MLB-BICYCLE_V_BRAKE_BRAKE_PADS,5,11,0,413163,100%
5515,MLM-AUTOMOTIVE_SHOCK_ABSORBER_BUMP_STOPS,1,2,0,413163,100%
5516,MLB-ELECTRIC_POLE_SAWS,7,3,0,413163,100%
5518,MLM-EMBROIDERY_DESIGNS,4,8,0,413163,100%
5520,MLB-COUNTERTOPS,28,45,0,413163,100%
5521,MLB-AUTOMOTIVE_MANUAL_TRANSMISSION_SHIFT_LEVERS,119,167,0,413163,100%
5522,MLB-INVISIBLE_PET_FENCES,20,54,0,413163,100%
5523,MLB-COLLECTIBLE_MILITARY_HELMETS,16,21,0,413163,100%
5524,MLM-PLUNGERS,2,3,0,413163,100%
5526,MLB-BEACH_PADDLES,34,51,0,413163,100%
5527,MLM-TOY_MIXERS,4,7,0,413163,100%
5528,MLB-CAR_EXHAUSTS,38,53,0,413163,100%
5529,MLM-MASONRY_TROWELS,2,1,0,413163,100%
5530,MLM-SKID_STEER_LOADERS,6,6,0,413163,100%
5531,MLB-SLEDGEHAMMERS,37,156,0,413163,100%
5533,MLB-AUTOMOTIVE_HOOD_INSULATION_PADS,14,14,0,413163,100%
5534,MLB-DOOR_STOPPERS,18,26,0,413163,100%
5536,MLM-DRONE_LANDING_GEARS,2,1,0,413163,100%
5537,MLM-BICYCLE_BELLS,3,3,0,413163,100%
5538,MLM-GRASS_PAVERS,1,1,0,413163,100%
5540,MLB-WALL_CHASERS,82,184,0,413163,100%
5542,MLB-WINDSHIELDS,292,381,0,413163,100%
5545,MLB-DRONE_BATTERY_CHARGERS,18,6,0,413163,100%
5546,MLM-REFEREE_CARDS,1,0,0,413163,100%
5547,MLB-HAND_BRAKE_CABLES,101,85,0,413163,100%
5548,MLB-HYDRAULIC_STACKERS,15,9,0,413163,100%
5550,MLB-AUTOMOTIVE_SUSPENSION_CONTROL_ARMS,384,369,0,413163,100%
5553,MLM-RADIOFREQUENCY_POWER_SUPPLIES,1,0,0,413163,100%
5555,MLB-DANCE_COSTUMES,64,83,0,413163,100%
5556,MLB-WELDING_RODS,158,272,0,413163,100%
5557,MLB-COMMERCIAL_KITCHEN_WORK_TABLES,47,86,0,413163,100%
5559,MLB-LOADERS,97,116,0,413163,100%
5561,MLB-STORAGE_DRUMS,57,86,0,413163,100%
5563,MLM-HOT_FOOD_DISPLAY_CASES,1,1,0,413163,100%
5564,MLB-TEMPERAS,26,23,0,413163,100%
5566,MLB-HAIR_DRYER_HOLDERS,20,21,0,413163,100%
5568,MLB-IRRIGATION_DRIPPERS,25,35,0,413163,100%
5569,MLM-GINS,5,8,0,413163,100%
5570,MLB-NASAL_CPAP_MASKS,33,30,0,413163,100%
5571,MLB-DOG_POOP_BAGS,17,31,0,413163,100%
5573,MLM-TACTICAL_FANNY_PACKS,3,2,0,413163,100%
5574,MLM-TOY_WASHING_MACHINES,2,1,0,413163,100%
5575,MLB-ELLIPTICAL_MACHINES,94,135,0,413163,100%
5576,MLM-DANCE_MATS,2,3,0,413163,100%
5577,MLM-IDENTIFICATION_WRISTBANDS,1,0,0,413163,100%
5578,MLM-HEDGE_TRIMMERS,6,5,0,413163,100%
5579,MLM-MARTIAL_ARTS_FOOT_GUARDS,2,5,0,413163,100%
5580,MLB-INDUSTRIAL_SAWS,116,219,0,413163,100%
5581,MLB-ENERGETIC_STONES,16,36,0,413163,100%
5583,MLB-PET_JACKETS_AND_COATS,27,42,0,413163,100%
5584,MLM-AUTOMOTIVE_REAR_BODY_TAIL_LIGHT_PANELS,3,5,0,413163,100%
5585,MLM-TOOL_ARMATURES,5,0,0,413163,100%
5586,MLB-MILK_POTS,68,102,0,413163,100%
5587,MLB-LIQUID_DOG_AND_CAT_REPELLENTS,7,15,0,413163,100%
5589,MLB-SAXOPHONE_MOUTHPIECES,159,236,0,413163,100%
5595,MLB-HEARING_AIDS,44,58,0,413163,100%
5596,MLM-DRONES_FLEX_CABLES,3,1,0,413163,100%
5598,MLB-MOTORCYCLE_KICK_LEVER_PEDAL_SPRINGS,7,14,0,413163,100%
5600,MLB-MONEY_BOXES,109,203,0,413163,100%
5601,MLM-AUTOMATIC_BARRIERS,7,14,0,413163,100%
5602,MLB-DOMESTIC_WORKER_UNIFORMS,23,49,0,413163,100%
5605,MLB-HEAT_SINKS,28,34,0,413163,100%
5607,MLB-MOTORCYCLE_SADDLEBAGS,107,139,0,413163,100%
5609,MLM-GUINEA_PIGS,6,10,0,413163,100%
5610,MLB-TACTICAL_UNIFORMS,40,42,0,413163,100%
5611,MLB-SCALE_RULERS,8,13,0,413163,100%
5613,MLB-DRUM_PEDALS,67,64,0,413163,100%
5614,MLB-LETTER_TRAYS,21,17,0,413163,100%
5615,MLB-INDUSTRIAL_VEGETABLE_AND_FRUIT_PEELERS,9,12,0,413163,100%
5617,MLB-INSECTICIDES,103,173,0,413163,100%
5618,MLB-BOOMERANGS,18,16,0,413163,100%
5619,MLM-MOTORCYCLE_WHEEL_HUBS,4,2,0,413163,100%
5620,MLM-CORK_SHEETS_AND_ROLLS,2,4,0,413163,100%
5621,MLM-SEX_MACHINES,1,1,0,413163,100%
5624,MLB-AUTOMOTIVE_INNER_TIE_RODS,55,53,0,413163,100%
5625,MLB-POLYURETHANE_LIQUID_FOAMS,24,45,0,413163,100%
5626,MLM-IAT_SENSORS,4,6,0,413163,100%
5627,MLM-AUTOMATIC_PAD_PRINTING_MACHINES,3,2,0,413163,100%
5628,MLB-SWIMMING_KICKBOARDS,26,44,0,413163,100%
5629,MLB-MOTORCYCLE_TAIL_LIGHTS,196,289,0,413163,100%
5630,MLB-ENGINE_VALVES_SPRING_RETAINERS,26,24,0,413163,100%
5631,MLM-TOILET_FLUSH_VALVES,3,2,0,413163,100%
5632,MLM-HAND_AND_FOOT_MASKS,6,12,0,413163,100%
5635,MLM-OFFSET_PRINTERS,6,5,0,413163,100%
5636,MLB-TRANSFER_CASES,27,23,0,413163,100%
5637,MLM-DC_POWER_JACK_CONNECTORS,5,5,0,413163,100%
5638,MLB-MOTORCYCLE_SPEEDOMETER_CABLES,49,51,0,413163,100%
5639,MLB-SNARE_DRUMS,102,178,0,413163,100%
5640,MLM-CANDY_AND_CHOCOLATE_JARS,2,0,0,413163,100%
5642,MLB-NOSE_SHAPERS,26,58,0,413163,100%
5643,MLB-BEER_FERMENTERS,42,41,0,413163,100%
5646,MLB-AUTOMOTIVE_BRAKE_MASTER_CYLINDER_RESERVOIRS,84,115,0,413163,100%
5647,MLB-MOTORCYCLE_CLUTCH_DISCS,100,117,0,413163,100%
5649,MLM-ANTI_STATIC_BAGS,3,9,0,413163,100%
5650,MLM-ROLLER_SKATE_WHEELS,4,0,0,413163,100%
5651,MLM-TEA_STORAGE_CHESTS,2,6,0,413163,100%
5652,MLM-HAIR_DRYER_HOLDERS,1,4,0,413163,100%
5653,MLB-WATER_DISPENSER_TOP_COVERS,26,23,0,413163,100%
5654,MLM-HAND_SAWS,10,8,0,413163,100%
5655,MLB-IRONING_BOARDS,104,230,0,413163,100%
5656,MLB-ENGINE_BLOCKS,61,86,0,413163,100%
5657,MLB-MOTORCYCLE_ENGINE_GASKET_SETS,80,78,0,413163,100%
5658,MLM-PLATE_COMPACTORS,2,1,0,413163,100%
5659,MLM-BABY_CAR_MIRRORS,4,3,0,413163,100%
5660,MLB-EROTIC_CLOTHING,47,54,0,413163,100%
5661,MLM-CONSTRUCTION_INSULATION_ROLLS,6,4,0,413163,100%
5662,MLM-SIM_CARD_EJECT_PINS,1,0,0,413163,100%
5664,MLB-SALTY_SNACKS,55,65,0,413163,100%
5665,MLB-3D_GLASSES,54,65,0,413163,100%
5667,MLM-EROTIC_PANTIES,6,9,0,413163,100%
5669,MLM-WATER_DISPENSER_TAPS,2,2,0,413163,100%
5670,MLM-SUGAR,3,8,0,413163,100%
5671,MLM-DOG_AND_CAT_BLANKETS,1,1,0,413163,100%
5672,MLM-CLAPPERBOARDS,4,6,0,413163,100%
5673,MLB-AUTOMOTIVE_ENGINE_VALVE_COVERS,124,127,0,413163,100%
5674,MLM-SEX_TOY_KITS,8,11,0,413163,100%
5677,MLM-BAKERY_MOULDERS,1,2,0,413163,100%
5678,MLM-POOL_HOSES,5,10,0,413163,100%
5680,MLB-TACTICAL_SUPPLY_KITS,34,72,0,413163,100%
5682,MLM-MAGNETIC_AQUARIUM_CLEANERS,1,1,0,413163,100%
5683,MLM-FLOPPY_DRIVES,2,3,0,413163,100%
5686,MLB-SKATEBOARD_DECKS,33,39,0,413163,100%
5687,MLB-WOOD_OVENS,79,208,0,413163,100%
5693,MLM-SHOE_BRUSHES,1,0,0,413163,100%
5694,MLM-INHALER_SPACERS,1,1,0,413163,100%
5695,MLM-FISHING_BOOTS,1,1,0,413163,100%
5696,MLM-AC_COMPRESSOR_CLUTCH_COILS,1,0,0,413163,100%
5699,MLB-MOTORCYCLE_FOOT_PEG_BRACKETS,114,133,0,413163,100%
5702,MLM-TIRE_SNOW_CHAINS,2,0,0,413163,100%
5703,MLB-KITCHEN_FUNNELS,23,26,0,413163,100%
5704,MLB-SKIN_REPELLENTS,33,48,0,413163,100%
5705,MLB-CATS_AND_DOGS_TREATS,62,85,0,413163,100%
5707,MLM-PARTY_POM_POMS,1,1,0,413163,100%
5708,MLB-INDUSTRIAL_IRONING_BOARDS,3,3,0,413163,100%
5709,MLB-DISPOSABLE_AND_REFILLABLE_RAZORS,79,144,0,413163,100%
5712,MLM-EDIBLE_MARKERS,2,2,0,413163,100%
5713,MLB-GARDEN_SOIL,61,72,0,413163,100%
5714,MLM-KID_SKATEBOARDS,2,6,0,413163,100%
5715,MLM-ELECTRIC_POTS_AND_SKILLETS,4,4,0,413163,100%
5716,MLM-AUTOMOTIVE_REVERSE_LIGHT_SWITCHES,4,4,0,413163,100%
5717,MLM-GROIN_GUARDS,5,6,0,413163,100%
5718,MLB-CULINARY_UNIFORMS,46,66,0,413163,100%
5719,MLB-CARBURETOR_CHOKE_CABLES,39,28,0,413163,100%
5720,MLB-WOODEN_CRATES,31,42,0,413163,100%
5722,MLB-GYM_WEIGHT_AND_BAR_RACKS,26,35,0,413163,100%
5724,MLM-GAME_CONSOLE_ACCESSORIES_KITS,3,3,0,413163,100%
5725,MLM-PINCERS,1,0,0,413163,100%
5726,MLB-ICE_CREAM_MACHINES,39,128,0,413163,100%
5727,MLM-AUTOMOTIVE_OBD_CABLE_ADAPTERS,3,16,0,413163,100%
5729,MLB-BANJOS,48,28,0,413163,100%
5730,MLM-WATER_TANK_LIDS,2,2,0,413163,100%
5732,MLM-ORTHODONTIC_RETAINER_BOXES,3,3,0,413163,100%
5733,MLM-RUGBY_JERSEYS,1,0,0,413163,100%
5734,MLM-SWIMMING_POOL_HEATERS,2,4,0,413163,100%
5735,MLM-INJECTION_PUMPS,5,3,0,413163,100%
5736,MLM-LIGHT_METERS,1,0,0,413163,100%
5738,MLM-BASIC_FOOD_BASKETS,1,1,0,413163,100%
5739,MLB-CURTAIN_RODS,48,77,0,413163,100%
5740,MLB-PARAGLIDERS,71,71,0,413163,100%
5741,MLM-STUFFED_PET_TOYS,1,1,0,413163,100%
5742,MLB-APARTMENTS_FOR_VACATION_RENTAL,65,70,0,413163,100%
5743,MLM-AUTOMOTIVE_HEADLIGHT_SUPPORT_BRACKETS,2,1,0,413163,100%
5744,MLM-GARDEN_MACHINE_TRIMMER_LINES,6,10,0,413163,100%
5746,MLM-KITCHEN_FORKS,5,3,0,413163,100%
5747,MLM-BICYCLE_SHIFTERS,11,10,0,413163,100%
5748,MLB-TOILETS,169,379,0,413163,100%
5749,MLM-TOY_GARAGES_AND_GAS_STATIONS,4,4,0,413163,100%
5751,MLM-PANTY_LINERS,1,5,0,413163,100%
5754,MLB-CHISELS,89,140,0,413163,100%
5755,MLM-ENGINE_COOLING_FAN_SWITCHES,8,11,0,413163,100%
5757,MLM-REFRIGERATOR_AND_FREEZER_CONTROL_BOARDS,1,1,0,413163,100%
5758,MLM-AUTOMOTIVE_AIR_SUSPENSION_KITS,1,1,0,413163,100%
5759,MLM-FOOD_STORAGE_CONTAINERS,2,1,0,413163,100%
5760,MLM-BATHROOM_EXHAUST_FANS,7,8,0,413163,100%
5761,MLM-CLASSICAL_GUITARS,8,17,0,413163,100%
5762,MLM-PROJECTOR_CASES_AND_BAGS,2,7,0,413163,100%
5763,MLM-MEDICAL_ULTRASOUND_SCANNERS,4,6,0,413163,100%
5764,MLM-BICYCLE_SEAT_COVERS,2,2,0,413163,100%
5769,MLB-BATH_SPONGES,38,49,0,413163,100%
5770,MLM-INTAKE_MANIFOLD_GASKET_SETS,4,3,0,413163,100%
5771,MLM-ALLERGY_MEDICINES,2,1,0,413163,100%
5773,MLM-GOLF_SHOES,4,4,0,413163,100%
5774,MLM-PLASTIC_INJECTION_MOLDS,4,5,0,413163,100%
5775,MLB-CARBURETOR_GASKET_SETS,29,34,0,413163,100%
5776,MLB-AUTOMOTIVE_SIDE_VIEW_MIRROR_SWITCHES,31,69,0,413163,100%
5777,MLM-POKER_SETS,3,3,0,413163,100%
5779,MLB-SWAY_BARS,57,66,0,413163,100%
5780,MLM-GPS_ANTENNAS,2,2,0,413163,100%
5781,MLM-VOLUMETRIC_FILLERS,3,12,0,413163,100%
5783,MLM-AUTOMOTIVE_SUNROOF_SWITCHES,3,3,0,413163,100%
5784,MLM-DIAPER_BAG_SETS,1,1,0,413163,100%
5785,MLB-HAIR_REMOVAL_STRIPS,56,108,0,413163,100%
5786,MLB-BIO_FIREPLACES,27,62,0,413163,100%
5787,MLM-BICYCLE_RACKS,1,1,0,413163,100%
5788,MLM-AUTOMOTIVE_CRANKSHAFT_GEARS,2,3,0,413163,100%
5789,MLM-SYRINGES,4,4,0,413163,100%
5790,MLB-YARNS,86,133,0,413163,100%
5791,MLB-SPORT_AND_MEDICAL_BANDAGES,62,148,0,413163,100%
5792,MLM-ANIMAL_PASTURE_BALES,1,0,0,413163,100%
5793,MLB-WALKIE_TALKIE_CHARGERS,20,13,0,413163,100%
5794,MLB-MOTORCYCLE_ENGINE_OIL_PANS,50,58,0,413163,100%
5795,MLM-ELECTRIC_GUN_GLUE_STICKS,2,2,0,413163,100%
5796,MLB-CUFFLINKS,17,14,0,413163,100%
5799,MLM-MECHANIC_CREEPERS,1,0,0,413163,100%
5802,MLB-WELDING_CURTAINS,12,7,0,413163,100%
5803,MLM-DECORATIVE_BARRELS,2,1,0,413163,100%
5805,MLB-MODEL_AIRCRAFT_RADIO_CONTROLS,48,53,0,413163,100%
5808,MLB-BABY_DIAPERS,37,53,0,413163,100%
5809,MLB-AUTOMOTIVE_FUSE_BOX_COVERS,15,17,0,413163,100%
5810,MLM-AQUARIUM_SKIMMERS,2,1,0,413163,100%
5814,MLB-MANUAL_SHEAR_SCISSORS,31,91,0,413163,100%
5816,MLM-REAR_WHEEL_HUBS_BEARING_ASSEMBLY,4,2,0,413163,100%
5817,MLB-AUTOMOTIVE_ENGINE_CAMSHAFT_TIMING_GEARS,9,8,0,413163,100%
5819,MLB-CARABINERS,32,47,0,413163,100%
5820,MLB-PASTA_MACHINES,114,164,0,413163,100%
5822,MLM-TANDEM_CHAIRS,8,10,0,413163,100%
5824,MLB-KIDS_BOWLING_GAMES,17,26,0,413163,100%
5825,MLB-FENCE_ORNAMENTS,6,8,0,413163,100%
5827,MLM-TRUMPET_MOUTHPIECES,6,6,0,413163,100%
5828,MLM-LAUNDRY_ROOM_CABINETS,1,1,0,413163,100%
5829,MLB-RACKET_STRINGS,33,19,0,413163,100%
5830,MLM-GRIPS_AND_OVERGRIPS,7,7,0,413163,100%
5831,MLM-BEER_BREWING_EQUIPMENTS,3,2,0,413163,100%
5832,MLM-STOVETOP_POPCORN_POPPERS,1,1,0,413163,100%
5833,MLM-INFLATABLES_AND_MECHANIC_BULLS_RENTAL_SERVICES,8,11,0,413163,100%
5834,MLB-SCISSORS,79,137,0,413163,100%
5837,MLB-NAUTICAL_FUEL_TANKS,44,61,0,413163,100%
5839,MLM-FISH_TANK_CO2_DIFFUSERS,3,2,0,413163,100%
5841,MLM-CELLPHONE_SOFTWARE,1,2,0,413163,100%
5842,MLB-IGNITION_KNOCK_SENSORS,40,41,0,413163,100%
5844,MLM-DECORATIVE_CHRISTMAS_BOOTS,3,4,0,413163,100%
5845,MLM-BICYCLE_CHAIN_GUARDS,3,4,0,413163,100%
5847,MLM-MANUAL_DOUGH_SHEETERS,2,6,0,413163,100%
5850,MLB-VEHICLE_CV_AXLES,156,153,0,413163,100%
5853,MLB-BICYCLE_BOTTOM_BRACKETS,28,41,0,413163,100%
5854,MLM-CLEANING_MOP_REPLACEMENTS,4,5,0,413163,100%
5855,MLM-HEATER_CORES,7,2,0,413163,100%
5856,MLM-INDUSTRIAL_GEARBOXES,2,2,0,413163,100%
5857,MLB-KITCHEN_SINK_CADDY_ORGANIZERS,66,90,0,413163,100%
5859,MLB-CAR_DISTRIBUTOR_ROTORS,9,10,0,413163,100%
5860,MLB-ELECTRONIC_AND_ELECTRICAL_CONTACT_CLEANERS,15,15,0,413163,100%
5863,MLB-VIBRATION_PLATFORMS,23,11,0,413163,100%
5864,MLB-LEG_WARMERS,40,59,0,413163,100%
5865,MLB-CAN_OPENERS,19,20,0,413163,100%
5866,MLM-AUTOMOTIVE_LIFTS,3,2,0,413163,100%
5867,MLM-RECIPROCATING_SAWS,2,1,0,413163,100%
5869,MLM-INDUSTRIAL_POWDER_AND_LIQUID_MIXER_MACHINES,1,1,0,413163,100%
5870,MLB-DJ_EFFECTS_PROCESSORS,103,152,0,413163,100%
5871,MLB-GEAR_HOBBING_MACHINES,4,7,0,413163,100%
5872,MLB-AUTOMOTIVE_CANISTER_PURGE_VALVES,9,4,0,413163,100%
5874,MLM-BICYCLE_KICKSTANDS,4,6,0,413163,100%
5875,MLM-EROTIC_MASSAGE_OILS,1,2,0,413163,100%
5876,MLM-EAR_COTTON_SWABS,2,4,0,413163,100%
5877,MLM-MOTORCYCLE_NECK_BRACES,1,2,0,413163,100%
5878,MLB-FORKLIFTS,55,59,0,413163,100%
5881,MLB-DRAFTING_KITS,13,26,0,413163,100%
5882,MLM-3D_PRINTER_HOTENDS,2,3,0,413163,100%
5883,MLB-CONGAS,23,17,0,413163,100%
5884,MLM-AUTOMOTIVE_HEATERS,1,1,0,413163,100%
5885,MLB-FISH_TANK_ALGAECIDES,32,18,0,413163,100%
5886,MLB-MEATS,28,33,0,413163,100%
5887,MLB-STEERING_COLUMNS,103,118,0,413163,100%
5888,MLM-PET_TRAINING_CLICKERS,1,2,0,413163,100%
5889,MLM-BINDING_COVERS,8,8,0,413163,100%
5892,MLM-SERVER_RACKS,2,0,0,413163,100%
5893,MLB-BALANCE_BICYCLES,43,72,0,413163,100%
5894,MLB-MODEL_NAVAL_SAILBOATS,8,16,0,413163,100%
5895,MLM-HYDROCHLORIC_ACID,1,0,0,413163,100%
5896,MLM-HARPS,2,2,0,413163,100%
5897,MLB-NAUTICAL_ROPES,66,82,0,413163,100%
5898,MLM-ELECTRONIC_SWITCHES,5,7,0,413163,100%
5900,MLM-AUTOMOTIVE_FUEL_TANKS,5,4,0,413163,100%
5901,MLM-DECORATIVE_TASSELS,1,1,0,413163,100%
5903,MLM-EDGE_PROTECTORS,3,5,0,413163,100%
5904,MLM-PIPE_CUTTERS,2,2,0,413163,100%
5905,MLM-ARM_SLINGS,3,3,0,413163,100%
5906,MLM-AUTOMOTIVE_SOLENOID_VALVES,1,0,0,413163,100%
5907,MLM-OTHER_PROPERTIES_FOR_SALE,2,0,0,413163,100%
5909,MLM-AUTOMOTIVE_AC_COMPRESSOR_BRACKETS,1,2,0,413163,100%
5910,MLM-LENS_CAPS,4,2,0,413163,100%
5911,MLM-TERRARIUM_HEATERS,10,10,0,413163,100%
5912,MLB-COMMERCIAL_STACKABLE_CRATES,20,27,0,413163,100%
5916,MLM-STOVETOP_GRILLS,2,2,0,413163,100%
5917,MLM-CAMPING_LANTERNS,2,3,0,413163,100%
5918,MLM-SKI_AND_SNOWBOARD_GOGGLES,6,6,0,413163,100%
5919,MLM-COUNTERFEIT_MONEY_DETECTOR_PENS,5,7,0,413163,100%
5922,MLM-NETWORK_CABLE_ADAPTERS,5,5,0,413163,100%
5924,MLB-CNC_LATHES,36,73,0,413163,100%
5926,MLB-GRAVY_BOATS,25,31,0,413163,100%
5927,MLB-PRINTER_FUSERS,53,56,0,413163,100%
5928,MLB-GARDEN_COMBUSTION_AUGERS,19,36,0,413163,100%
5929,MLM-DJ_MIXERS,1,1,0,413163,100%
5930,MLB-NAIL_POLISH_DRYER_SPRAYS,8,7,0,413163,100%
5931,MLB-CAMERA_SLIDERS,22,36,0,413163,100%
5932,MLB-DIGITAL_PIANOS,156,171,0,413163,100%
5933,MLB-ONE_PIECE_PAJAMAS,38,152,0,413163,100%
5934,MLM-DRUM_KEYS,8,8,0,413163,100%
5935,MLM-CELLPHONE_FANS,4,4,0,413163,100%
5936,MLM-TOOL_CARTS,1,1,0,413163,100%
5937,MLB-CHURRO_AND_COOKIE_PRESS_GUNS,38,55,0,413163,100%
5939,MLB-BOMBOS,26,33,0,413163,100%
5940,MLB-HABERDASHERY_LACE_EDGINGS,60,72,0,413163,100%
5942,MLB-MODEL_NAVAL_ACCESSORIES,19,29,0,413163,100%
5943,MLB-LAPTOP_REPLACEMENT_TOUCHPADS,12,10,0,413163,100%
5944,MLM-MODELISM_CONNECTORS,1,0,0,413163,100%
5945,MLB-SAFETY_HARNESSES,12,13,0,413163,100%
5948,MLM-EYEBROW_TRIMMERS,3,1,0,413163,100%
5949,MLB-SLACKLINE_KITS,24,32,0,413163,100%
5950,MLB-GARDEN_MACHINE_TRIMMER_LINES,37,45,0,413163,100%
5951,MLM-POOL_WATERFALLS,3,29,0,413163,100%
5954,MLM-WINE_ACCESSORY_SETS,4,16,0,413163,100%
5956,MLM-CLUTCH_SLAVE_CYLINDERS,6,4,0,413163,100%
5958,MLB-TOY_PEDAL_GO_KARTS,9,8,0,413163,100%
5959,MLB-ANTIQUE_RECORDS,6,17,0,413163,100%
5960,MLM-SEWING_KITS,2,4,0,413163,100%
5961,MLB-SUBMERSIBLE_PARTY_LIGHTS,3,1,0,413163,100%
5962,MLB-NAUTICAL_AIR_BLOWERS,8,9,0,413163,100%
5963,MLB-COMPUTER_KEYBOARD_COVERS,28,42,0,413163,100%
5965,MLB-FURNITURE_LEGS,43,58,0,413163,100%
5967,MLM-CUTTING_MATS,3,3,0,413163,100%
5968,MLB-HAIR_CLIPS,19,17,0,413163,100%
5969,MLB-SPORTS_TICKETS,54,75,0,413163,100%
5971,MLM-ZAFUS,4,3,0,413163,100%
5975,MLB-SHOWER_BASES,16,21,0,413163,100%
5976,MLM-CACAO,8,6,0,413163,100%
5977,MLB-AUTOMOTIVE_DISTRIBUTOR_VACUUM_ADVANCES,5,5,0,413163,100%
5979,MLB-MOTORCYCLE_VOLTAGE_REGULATORS,119,140,0,413163,100%
5980,MLM-MANUAL_PET_BALL_LAUNCHERS,1,0,0,413163,100%
5981,MLB-PLASTIC_GRINDING_MACHINES,16,18,0,413163,100%
5982,MLM-HAIR_DYEING_PAPERS,1,0,0,413163,100%
5983,MLB-SCREEN_CLEANERS,10,5,0,413163,100%
5984,MLB-PERCUSSION_MARACAS,4,8,0,413163,100%
5985,MLB-SPORT_DRESSES,13,28,0,413163,100%
5986,MLM-FARM_HOUSES_FOR_SALE,2,1,0,413163,100%
5987,MLM-BABY_STROLLER_WEATHER_SHIELDS,2,2,0,413163,100%
5988,MLM-INFLATABLE_SLIDES,2,2,0,413163,100%
5989,MLM-AUTOMOTIVE_HOOD_INSULATION_PADS,6,4,0,413163,100%
5990,MLM-HORSE_HALTERS,2,2,0,413163,100%
5992,MLB-BONGOS,39,62,0,413163,100%
5993,MLM-HYDRAULIC_POWER_UNITS,2,2,0,413163,100%
5994,MLM-TELESCOPIC_POST_SHORES,2,1,0,413163,100%
5995,MLB-MODEL_AIRCRAFT_ELECTRIC_MOTORS,23,33,0,413163,100%
5996,MLM-GOLF_BALLS,4,4,0,413163,100%
5998,MLM-STICKER_ALBUMS,3,0,0,413163,100%
5999,MLM-MORTAR_MUDDLERS,4,7,0,413163,100%
6000,MLM-SCHOOL_AND_OFFICE_PINS_AND_TACKS,2,5,0,413163,100%
6002,MLM-HAIR_REMOVAL_STRIPS,2,3,0,413163,100%
6003,MLB-CONSTRUCTION_FLEXIBLE_TUBES,11,20,0,413163,100%
6004,MLM-ROCK_CRUSHERS,1,1,0,413163,100%
6005,MLM-MANUAL_OIL_CANS,2,1,0,413163,100%
6006,MLB-FEELER_GAUGES,15,29,0,413163,100%
6007,MLB-MULTIGAME_MACHINE_CARDS,36,55,0,413163,100%
6008,MLM-DRONE_PROPELLERS,4,3,0,413163,100%
6009,MLB-ELECTRIC_VEGETABLE_AND_FRUIT_PEELERS,9,22,0,413163,100%
6011,MLM-RAZOR_CARTRIDGES,3,4,0,413163,100%
6012,MLM-HEADSET_TELEPHONES,4,7,0,413163,100%
6014,MLM-COOKING_PLOW_DISCS,2,3,0,413163,100%
6015,MLB-PENCIL_HOLDERS,42,39,0,413163,100%
6016,MLB-GARDENING_AND_AGRICULTURE_FABRICS_AND_PROTECTIVE_PLASTICS,40,41,0,413163,100%
6018,MLM-DJEMBES,5,1,0,413163,100%
6019,MLM-GOLF_CLUBS_SETS,3,3,0,413163,100%
6020,MLM-TOBACCO_PIPES,1,1,0,413163,100%
6021,MLM-LIP_PLUMPER_DEVICES,2,4,0,413163,100%
6022,MLB-DISC_HARROWS,7,7,0,413163,100%
6024,MLB-MICRODERMABRASION_MACHINES,72,145,0,413163,100%
6025,MLM-REFRIGERATION_STRIP_CURTAINS,3,3,0,413163,100%
6026,MLM-CHINCHILLAS,1,1,0,413163,100%
6027,MLM-ELECTRIC_TIRE_CHANGERS,6,2,0,413163,100%
6028,MLM-FIBER_OPTIC_CLEAVERS,3,7,0,413163,100%
6031,MLM-AUTOMOTIVE_GLOVE_BOXES,1,1,0,413163,100%
6032,MLM-BABY_PHOTOGRAPHIC_POSITIONERS,1,1,0,413163,100%
6033,MLM-WASTE_CONTAINERS,4,2,0,413163,100%
6034,MLB-PDA_CASES_AND_BAGS,8,7,0,413163,100%
6035,MLM-EXPANDED_POLYSTYRENE_SHEETS,8,1,0,413163,100%
6036,MLB-CNC_ROUTERS,68,96,0,413163,100%
6037,MLM-DANCE_METATARSAL_PROTECTORS,3,3,0,413163,100%
6038,MLB-RETAIL_SPACE_FOR_RENT,129,128,0,413163,100%
6040,MLB-FARM_HOUSES_FOR_RENT,77,94,0,413163,100%
6041,MLB-SURFBOARD_TRACTION_PADS,31,40,0,413163,100%
6042,MLB-CRAYONS,36,36,0,413163,100%
6043,MLB-ELECTRIC_FLOAT_SWITCHES,48,57,0,413163,100%
6044,MLM-AUTOMOTIVE_HEADRESTS,4,2,0,413163,100%
6046,MLB-PATIENT_LIFTS,18,8,0,413163,100%
6047,MLB-RECTIFIER_DIODES,84,105,0,413163,100%
6048,MLB-POLYFUSION_DEVICES,26,56,0,413163,100%
6049,MLB-LEARNING_MAZES,47,52,0,413163,100%
6052,MLM-MANUAL_CLOTH_FOLDING_BOARDS,1,1,0,413163,100%
6053,MLB-ELECTRIC_BLANKETS,18,6,0,413163,100%
6054,MLB-AUTOMOTIVE_CLUTCH_DISCS,56,46,0,413163,100%
6055,MLM-BEARING_BALLS,1,0,0,413163,100%
6056,MLB-KITESURF_HARNESSES,6,9,0,413163,100%
6057,MLB-FIBER_OPTIC_CLEAVERS,15,9,0,413163,100%
6059,MLM-PDA,3,5,0,413163,100%
6060,MLB-SHAWLS,6,3,0,413163,100%
6061,MLM-IDENTIFICATION_AND_PRESENTATION_CARD_CUTTERS,3,8,0,413163,100%
6063,MLM-ELECTRIC_VEGETABLE_AND_FRUIT_PEELERS,1,0,0,413163,100%
6064,MLM-INDUSTRIAL_IRONING_BOARDS,2,2,0,413163,100%
6065,MLM-CAT_HOUSES,4,5,0,413163,100%
6066,MLB-ANTIQUE_CHANDELIERS,32,32,0,413163,100%
6067,MLB-ORTHOPEDIC_CANES,8,11,0,413163,100%
6069,MLB-BABY_BOTTLE_BRUSHES,34,27,0,413163,100%
6070,MLB-VEHICLE_ROOF_AIR_COOLERS,28,85,0,413163,100%
6071,MLB-GUN_GRIPS,41,74,0,413163,100%
6072,MLB-BICYCLE_MIRRORS,34,36,0,413163,100%
6074,MLB-BAR_CHIMES,13,12,0,413163,100%
6075,MLM-STATIONARY_ENGINES,6,6,0,413163,100%
6076,MLB-TOILET_BRUSHES,32,35,0,413163,100%
6078,MLB-BUGGYS,76,122,0,413163,100%
6082,MLB-ELBOW_SUPPORTS,29,39,0,413163,100%
6083,MLB-BASIC_FOOD_BASKETS,94,301,0,413163,100%
6084,MLB-AUTOMOTIVE_CLUTCH_FLYWHEELS,22,15,0,413163,100%
6085,MLB-DEVICE_PROGRAMMERS,101,155,0,413163,100%
6086,MLB-MODEL_RAILROADING_TRACKS,20,19,0,413163,100%
6087,MLB-KANGOO_JUMPS,23,24,0,413163,100%
6088,MLB-POKER_TABLES,26,25,0,413163,100%
6089,MLM-MECHANICAL_TALLY_COUNTERS,3,7,0,413163,100%
6090,MLM-GINGERBREADS,1,0,0,413163,100%
6091,MLB-AUTOMOTIVE_CAT_EYE_REFLECTORS,49,63,0,413163,100%
6092,MLM-DOUBLE_BASSES,2,1,0,413163,100%
6094,MLM-HABERDASHERY_FABRIC_FLOWERS,1,0,0,413163,100%
6095,MLM-EXHAUST_MANIFOLD_GASKET_SETS,2,4,0,413163,100%
6096,MLB-PLASTERING_MACHINES,25,63,0,413163,100%
6097,MLM-GROOVE_JOINT_PLIERS,2,3,0,413163,100%
6098,MLM-ROWING_PADDLES,2,0,0,413163,100%
6099,MLB-ROTATING_TOOLS_POLISHING_BRUSHES,150,211,0,413163,100%
6101,MLB-STAMP_PUNCHES,30,57,0,413163,100%
6103,MLB-PLASTIC_INJECTION_MOLDING_MACHINES,17,7,0,413163,100%
6104,MLB-CLEANING_AND_BATH_SPONGE_HOLDERS,3,2,0,413163,100%
6105,MLM-BICYCLE_PROTECTORS,1,1,0,413163,100%
6107,MLB-DRAWING_AND_SKETCH_PADS,15,28,0,413163,100%
6108,MLB-PET_SANITARY_SHOVELS,4,8,0,413163,100%
6110,MLM-NAUTICAL_PARTS,1,1,0,413163,100%
6111,MLB-LATHES,216,351,0,413163,100%
6112,MLM-BICYCLE_WHEEL_AXLES,1,2,0,413163,100%
6114,MLM-SPARK_PLUG_WRENCHES,1,5,0,413163,100%
6118,MLB-CEMENT,26,55,0,413163,100%
6120,MLM-MANUAL_CREASERS,1,1,0,413163,100%
6122,MLB-MODELING_TOOL_SETS,3,1,0,413163,100%
6123,MLM-GLASS_BLOCKS,5,4,0,413163,100%
6125,MLB-MOTORCYCLE_AND_ALL_TERRAIN_VEHICLE_LOADING_RAMPS,20,27,0,413163,100%
6126,MLB-DIAPER_ORGANIZERS,67,53,0,413163,100%
6128,MLB-SPLINTS,21,17,0,413163,100%
6130,MLB-CAPTAIN_ARMBANDS,18,46,0,413163,100%
6131,MLB-TOILET_DEODORIZERS,9,8,0,413163,100%
6132,MLM-GONIOMETERS,1,1,0,413163,100%
6133,MLB-FLYBACK_TRANSFORMERS,24,23,0,413163,100%
6134,MLB-TATTOO_CLIP_CORDS,11,22,0,413163,100%
6135,MLB-VIDEO_GAME_DRUMS,9,11,0,413163,100%
6137,MLM-INDUSTRIAL_DUST_COLLECTORS,1,0,0,413163,100%
6138,MLB-FAX_MACHINES,18,19,0,413163,100%
6139,MLB-MOTORCYCLE_TRANSMISSION_CROWNS,178,277,0,413163,100%
6140,MLB-PET_COLOGNES_AND_PERFUMES,80,73,0,413163,100%
6141,MLB-VIDEO_GAME_GUITARS,36,49,0,413163,100%
6142,MLM-SHUT_OFF_VALVES,2,3,0,413163,100%
6143,MLM-TABLE_TENNIS_SETS,1,1,0,413163,100%
6144,MLM-CUP_DISPENSERS,2,2,0,413163,100%
6145,MLM-PYROTECHNICS,2,1,0,413163,100%
6146,MLM-WASHING_MACHINE_LINT_FILTERS,3,4,0,413163,100%
6147,MLM-TREADMILL_LUBRICANTS,2,1,0,413163,100%
6148,MLM-GARAGE_WALL_PROTECTORS,1,1,0,413163,100%
6151,MLB-MOTORCYCLE_LUGGAGE_RACKS,116,162,0,413163,100%
6152,MLB-CAMERA_CASES,72,99,0,413163,100%
6153,MLB-DRAWING_COMPASSES,20,16,0,413163,100%
6155,MLM-TRAILER_HITCHES,1,0,0,413163,100%
6156,MLM-BABY_JOURNALS,1,1,0,413163,100%
6157,MLB-CONVENTION_TICKETS,15,47,0,413163,100%
6158,MLB-CANVAS_AND_WOODEN_FRAMES,109,195,0,413163,100%
6159,MLB-DECORATIVE_MASKS,3,11,0,413163,100%
6160,MLM-CAMPING_THERMAL_MATS,1,1,0,413163,100%
6163,MLM-GPS_CASES_AND_COVERS,1,1,0,413163,100%
6164,MLM-BUOYANCY_COMPENSATORS,3,2,0,413163,100%
6165,MLB-WATER_SPORTS_BOARD_BAGS,26,44,0,413163,100%
6166,MLB-BATHTUBS,107,268,0,413163,100%
6167,MLB-TIPPED_PLIERS,40,73,0,413163,100%
6169,MLB-MEDICAL_TOURNIQUETS,5,8,0,413163,100%
6170,MLB-INDUSTRIAL_FOOD_PROCESSORS,39,38,0,413163,100%
6171,MLM-MOTORCYCLE_GRAB_BARS,2,2,0,413163,100%
6172,MLM-PASTAS,2,2,0,413163,100%
6173,MLB-CHIPPER_SHREDDERS,60,114,0,413163,100%
6174,MLB-POWER_STEERING_HOSES,106,95,0,413163,100%
6175,MLB-CMOS_CELL_BATTERIES,40,46,0,413163,100%
6176,MLB-ENGINE_VALVE_SPRINGS,9,11,0,413163,100%
6177,MLM-PDA_BATTERIES,2,3,0,413163,100%
6178,MLB-GLASSES_REPLACEMENT_LENSES,16,29,0,413163,100%
6180,MLB-HOME_HEATERS,9,50,0,413163,100%
6181,MLB-CHRISTMAS_WREATHS,93,81,0,413163,100%
6182,MLM-TOOL_ELECTRIC_SHARPENERS,5,4,0,413163,100%
6184,MLB-BICYCLE_BOTTLE_CAGES,107,153,0,413163,100%
6185,MLB-MODEL_RAILROADING_TRAINS,29,42,0,413163,100%
6186,MLB-GRAIN_GRINDING_MACHINES,14,14,0,413163,100%
6187,MLB-FISHING_SINKERS,36,50,0,413163,100%
6188,MLM-CREMATORY_OVENS,1,3,0,413163,100%
6190,MLB-ADULT_ELECTRIC_TRICYCLES,12,19,0,413163,100%
6191,MLM-AUTOMOTIVE_INTERIOR_REARVIEW_MIRRORS,2,2,0,413163,100%
6192,MLM-VEGETABLE_AND_FRUIT_SORTING_MACHINES,1,1,0,413163,100%
6193,MLB-COLLECTIBLE_CANS_BOTTLES_AND_SODA_SIPHONS,93,96,0,413163,100%
6195,MLB-STORE_SHOPPING_CARTS,11,31,0,413163,100%
6196,MLM-BATH_AND_SAUNA_STEAM_GENERATORS,1,1,0,413163,100%
6197,MLM-EROTIC_GARTER_BELTS,2,0,0,413163,100%
6198,MLM-PARTY_HEADBANDS_CROWNS_AND_TIARAS,1,2,0,413163,100%
6199,MLM-EDIBLE_PAPERS,1,0,0,413163,100%
6200,MLB-ELECTRIC_UNICYCLES,29,64,0,413163,100%
6201,MLB-LAWN_MOWER_WHEELS,13,21,0,413163,100%
6202,MLM-EROTIC_WOMEN_SWIMWEAR,2,2,0,413163,100%
6203,MLM-CLIMBING_SLINGS,1,1,0,413163,100%
6204,MLM-SWIMMING_EARPLUGS,3,14,0,413163,100%
6205,MLB-CEREALS,34,40,0,413163,100%
6206,MLB-DOOR_HANDLES,9,11,0,413163,100%
6209,MLM-PHOTOGRAPHY_BACKDROP_STANDS,3,3,0,413163,100%
6211,MLM-EMBROIDERY_NEEDLES,6,12,0,413163,100%
6213,MLB-AUTOMOTIVE_HEATER_VALVES,6,8,0,413163,100%
6214,MLB-MOTORCYCLE_GOGGLES,54,84,0,413163,100%
6217,MLM-ALTERNATOR_PULLEYS,5,2,0,413163,100%
6218,MLM-PENCIL_HOLDERS,2,4,0,413163,100%
6221,MLM-POWER_SUPPLY_TESTERS,4,4,0,413163,100%
6222,MLB-ELECTRIC_SUGAR_CANE_JUICERS,80,113,0,413163,100%
6223,MLB-LIP_LINERS,4,7,0,413163,100%
6224,MLM-AUTOMOTIVE_AC_PANEL_KNOBS,2,2,0,413163,100%
6225,MLM-MOTORCYCLE_BRAKE_RODS,2,3,0,413163,100%
6226,MLB-ACCORDION_STRAPS,24,17,0,413163,100%
6227,MLM-BALLOON_STICKS,1,2,0,413163,100%
6228,MLM-DESICCANT_BAGS,6,8,0,413163,100%
6229,MLM-MOTORCYCLE_WHEEL_SPOKES,3,4,0,413163,100%
6231,MLM-COCKROACHES,3,7,0,413163,100%
6232,MLB-MODELISM_CONNECTORS,22,18,0,413163,100%
6233,MLM-WASHING_MACHINE_DOOR_AND_LID_GASKETS,1,1,0,413163,100%
6234,MLM-OFFICE_STAPLER_STAPLES,3,3,0,413163,100%
6235,MLM-PORTABLE_SMOKING_GUNS,1,0,0,413163,100%
6236,MLM-PEGBOARDS_TOOL_STORAGE,2,4,0,413163,100%
6237,MLM-DISC_CARRYING_CASES,2,3,0,413163,100%
6240,MLB-FRUIT_PULPS,18,37,0,413163,100%
6241,MLM-MAILBOXES,4,4,0,413163,100%
6242,MLB-PERGOLAS,91,134,0,413163,100%
6244,MLB-BIRD_NESTS,25,30,0,413163,100%
6246,MLB-AUTOMOTIVE_IDLE_AIR_CONTROL_VALVES,140,156,0,413163,100%
6251,MLB-POOL_CLEANERS,32,58,0,413163,100%
6252,MLM-MOTORCYCLE_ENGINE_CONNECTING_RODS,4,9,0,413163,100%
6255,MLM-BANJOS,2,2,0,413163,100%
6256,MLB-BICYCLE_BRAKE_AND_SHIFTER_CABLES,19,26,0,413163,100%
6257,MLB-LENS_FILTERS,61,64,0,413163,100%
6258,MLB-HAMBURGER_FORMERS,9,26,0,413163,100%
6260,MLB-COMPUTER_MONITOR_RISER_STANDS,10,12,0,413163,100%
6263,MLB-FIBER_OPTIC_POWER_METERS,13,24,0,413163,100%
6265,MLM-CONDUCTIVITY_METERS,2,1,0,413163,100%
6266,MLM-CANDELABRAS,4,4,0,413163,100%
6268,MLB-BICYCLE_BELLS,16,19,0,413163,100%
6269,MLB-COTTON_SWAB_HOLDERS,17,21,0,413163,100%
6270,MLM-HYDRAULIC_STACKERS,1,3,0,413163,100%
6271,MLB-MOSSES,20,22,0,413163,100%
6272,MLM-MATCHSTICKS,1,1,0,413163,100%
6273,MLM-DECORATIVE_BLANKETS,1,3,0,413163,100%
6274,MLB-FISHING_PANTS,46,38,0,413163,100%
6276,MLM-SAILBOATS,2,2,0,413163,100%
6279,MLB-MARTIAL_ARTS_FOCUS_MITTS_AND_RACKETS,23,41,0,413163,100%
6281,MLM-3D_PRINTER_THERMISTORS,1,0,0,413163,100%
6283,MLM-GARLIC_PRESSES,2,2,0,413163,100%
6284,MLM-AUTOMOTIVE_AC_COMPRESSOR_CONTROL_VALVES,1,1,0,413163,100%
6285,MLM-TENNIS_NETS,1,1,0,413163,100%
6286,MLM-INDUSTRIAL_LIQUID_CHILLERS,1,1,0,413163,100%
6288,MLB-WIRELESS_CHARGING_RECEIVERS,28,40,0,413163,100%
6290,MLB-MOTORCYCLE_STARTER_SWITCH_IGNITIONS,70,93,0,413163,100%
6293,MLB-BABY_NESTS,10,13,0,413163,100%
6295,MLB-BDSM_WHIPS,3,0,0,413163,100%
6296,MLB-LOCKERS,48,51,0,413163,100%
6297,MLM-FISH_TANK_ALGAECIDES,1,1,0,413163,100%
6298,MLB-RUGBY_BALLS,4,4,0,413163,100%
6299,MLB-ANILINE_DYES,6,11,0,413163,100%
6300,MLB-DJ_RACKS,40,41,0,413163,100%
6302,MLM-PORTABLE_TACHOMETERS,1,2,0,413163,100%
6305,MLM-DEBRIS_BAGS,1,0,0,413163,100%
6306,MLB-COMMERCIAL_POPCORN_MACHINES,20,26,0,413163,100%
6308,MLM-TRANSPARENCY_PROJECTORS,1,0,0,413163,100%
6309,MLM-AUDITORIUM_SEATING,1,0,0,413163,100%
6310,MLB-TONFAS,25,31,0,413163,100%
6311,MLM-ELECTRIC_CAN_OPENERS,1,6,0,413163,100%
6312,MLM-DRONE_BODY_SHELLS,1,1,0,413163,100%
6318,MLB-ALTERNATIVE_THERAPY_EQUIPMENT,24,27,0,413163,100%
6319,MLB-TROMBONES,49,48,0,413163,100%
6320,MLB-AUTOMOTIVE_HEATERS,15,32,0,413163,100%
6322,MLB-NEMA_ENCLOSURES,39,45,0,413163,100%
6324,MLB-GLOW_PLUG_CONTROLLERS,15,13,0,413163,100%
6325,MLM-PROXIMITY_CARDS,2,3,0,413163,100%
6326,MLB-PAINT_MACHINES,15,13,0,413163,100%
6328,MLB-CAR_LICENSE_PLATE_LIGHTS,10,12,0,413163,100%
6330,MLB-GARDEN_STONES,42,76,0,413163,100%
6331,MLB-MANUAL_PAD_PRINTING_MACHINES,2,3,0,413163,100%
6333,MLB-AIR_COMPRESSOR_PUMPS,7,6,0,413163,100%
6334,MLB-PADDLE_TENNIS_RACKETS,8,11,0,413163,100%
6335,MLB-CAR_QUARTER_GLASSES,17,15,0,413163,100%
6336,MLB-VACUUM_TUBES,27,36,0,413163,100%
6337,MLB-AUTOMOTIVE_DASHBOARD_COVERS,12,21,0,413163,100%
6338,MLB-ANTIQUE_REFRIGERATORS,53,82,0,413163,100%
6339,MLB-BATH_TOYS,25,38,0,413163,100%
6340,MLB-EXFOLIATING_GLOVES,12,23,0,413163,100%
6341,MLM-PAELLA_PANS,7,4,0,413163,100%
6342,MLB-CAMPING_COTS,18,10,0,413163,100%
6344,MLB-FOOD_VACUUM_SEALERS,20,40,0,413163,100%
6345,MLM-PATIENT_LIFTS,5,9,0,413163,100%
6346,MLM-ELECTRIC_POLE_SAWS,1,1,0,413163,100%
6347,MLM-HABERDASHERY_STUDS,5,2,0,413163,100%
6349,MLB-ENGINE_TAPPET_GUIDE_HOLDS,104,130,0,413163,100%
6350,MLB-AIRSOFT_GUN_REPLACEMENT_SPRINGS,19,30,0,413163,100%
6352,MLB-TERRARIUM_THERMOMETERS,1,1,0,413163,100%
6353,MLM-CAR_DISTRIBUTOR_ROTORS,1,0,0,413163,100%
6354,MLB-AUTOMOTIVE_SHOCK_ABSORBER_BUMP_STOPS,20,20,0,413163,100%
6355,MLM-MOTORCYCLE_REAR_COWLS,2,3,0,413163,100%
6358,MLM-BABY_OILS,2,2,0,413163,100%
6360,MLB-DECORATIVE_CHRISTMAS_BOOTS,9,7,0,413163,100%
6362,MLB-MOTORCYCLE_RADIATOR_FANS,12,9,0,413163,100%
6364,MLB-JEWELRY_ROLLS,22,20,0,413163,100%
6370,MLB-TELEPHONE_FILTERS,5,6,0,413163,100%
6372,MLB-TABLE_FRUIT_BOWLS,114,153,0,413163,100%
6373,MLB-BICYCLE_FENDERS,33,44,0,413163,100%
6374,MLB-READING_STANDS,33,39,0,413163,100%
6375,MLB-DISHWASHING_DETERGENTS,13,16,0,413163,100%
6377,MLB-BATHTUB_PILLOWS,15,46,0,413163,100%
6381,MLM-MOTORCYCLE_RUBBER_DAMPERS,1,1,0,413163,100%
6382,MLB-SUP_BOARDS,26,39,0,413163,100%
6383,MLB-BARBED_WIRES,50,67,0,413163,100%
6386,MLB-WALL_BRACKETS,18,41,0,413163,100%
6387,MLB-PIANO_TUNING_TOOLS,10,4,0,413163,100%
6388,MLB-TENNIS_WRISTBANDS,20,17,0,413163,100%
6389,MLB-KIDS_PLAYSETS,59,124,0,413163,100%
6390,MLM-DENTAL_INSTRUMENT_KITS,1,1,0,413163,100%
6391,MLB-GUINEA_PIGS,23,38,0,413163,100%
6392,MLB-GAIOLAS,25,20,0,413163,100%
6393,MLB-SCULPTURED_NAIL_FORMS,22,26,0,413163,100%
6394,MLB-EROTIC_LINGERIE_SETS,5,2,0,413163,100%
6395,MLB-KIDS_PLAYHOUSES,171,482,0,413163,100%
6397,MLB-ELECTRIC_PAPER_CREASERS,15,27,0,413163,100%
6398,MLB-MOTORCYCLE_BRAKE_DRUM_COVERS,26,22,0,413163,100%
6399,MLM-RACKET_STRINGS,1,2,0,413163,100%
6400,MLM-PLOW_DISC_BURNERS,1,2,0,413163,100%
6402,MLB-ROLLER_SKATE_WHEELS,57,71,0,413163,100%
6403,MLB-ART_PAPERS,11,20,0,413163,100%
6404,MLM-MOTORCYCLE_SIDE_CASES,1,0,0,413163,100%
6405,MLM-GOLF_BAGS,1,1,0,413163,100%
6406,MLM-MOTORCYCLE_SPARK_PLUG_CAPS,1,1,0,413163,100%
6407,MLB-CAMERA_VIEWFINDERS,5,1,0,413163,100%
6408,MLB-HOES,72,118,0,413163,100%
6409,MLB-RECIPROCATING_SAWS,34,65,0,413163,100%
6411,MLB-DISC_CARRYING_CASES,50,29,0,413163,100%
6412,MLM-ELECTRIC_BLANKETS,2,5,0,413163,100%
6413,MLM-VEHICLE_OIL_FILTER_WRENCHES,3,3,0,413163,100%
6414,MLM-MOTORCYCLE_CLUTCH_COVER_GASKETS,1,2,0,413163,100%
6415,MLB-FARMS_FOR_SALE,86,92,0,413163,100%
6416,MLB-CERAMIC_KILNS,7,9,0,413163,100%
6417,MLB-GARDENING_AND_CONSTRUCTION_SHOVELS,15,19,0,413163,100%
6418,MLB-NAUTICAL_ANODES,33,28,0,413163,100%
6419,MLB-NIPPLE_CLAMPS,3,4,0,413163,100%
6422,MLM-PRINTER_SPARE_TRAYS,3,5,0,413163,100%
6423,MLM-FABRIC_WATER_REPELLENT_PRODUCTS,1,3,0,413163,100%
6425,MLB-REAR_WHEEL_HUBS_BEARING_ASSEMBLY,83,81,0,413163,100%
6426,MLM-CUPCAKES,1,2,0,413163,100%
6427,MLM-OTHER_PROPERTIES_FOR_RENT,2,1,0,413163,100%
6428,MLM-BATH_SPONGES,1,0,0,413163,100%
6429,MLM-POOL_MAIN_DRAINS,2,2,0,413163,100%
6430,MLM-LED_CHIPS,2,2,0,413163,100%
6431,MLB-TOUCHPADS,7,0,0,413163,100%
6432,MLM-ANTI_FATIGUE_MATS,1,2,0,413163,100%
6434,MLB-FLIP_FLOP_MAKING_MACHINES,62,93,0,413163,100%
6435,MLB-DRAWING_BOARDS_AND_TABLES,4,7,0,413163,100%
6436,MLB-ICE_CREAM_SERVING_SPOONS,38,80,0,413163,100%
6437,MLB-AUTOMOTIVE_SOLENOID_VALVES,15,24,0,413163,100%
6438,MLM-EROTIC_VIBRATING_BUTTERFLIES,2,1,0,413163,100%
6439,MLM-MEAT_TENDERIZER_TOOLS,2,0,0,413163,100%
6440,MLB-LABEL_PRINTERS,14,27,0,413163,100%
6442,MLB-FRENCH_HORNS,40,82,0,413163,100%
6443,MLB-MOTORCYCLE_WHEEL_AXLES,28,26,0,413163,100%
6445,MLB-EROTIC_MAGAZINES,93,99,0,413163,100%
6446,MLB-TV_REPLACEMENT_LAMPS,20,23,0,413163,100%
6447,MLB-CELLPHONE_SOFTWARE,28,42,0,413163,100%
6448,MLB-FLOPPY_DRIVE_EMULATORS,5,10,0,413163,100%
6449,MLM-BICYCLE_COMBUSTION_ENGINE_KITS,1,2,0,413163,100%
6450,MLM-AUTOMOTIVE_SIDE_VIEW_MIRROR_SWITCHES,2,1,0,413163,100%
6451,MLM-JUICE_DISPENSER_COOLERS,2,3,0,413163,100%
6452,MLM-GRADUATED_CYLINDERS,1,1,0,413163,100%
6453,MLB-AMERICAN_FOOTBALL_GLOVES,2,0,0,413163,100%
6454,MLB-MOTORCYCLE_METER_CASES,51,58,0,413163,100%
6455,MLB-AQUARIUM_GRAVEL_CLEANERS,19,23,0,413163,100%
6456,MLM-PET_BEDDINGS,5,6,0,413163,100%
6460,MLB-HABERDASHERY_FRINGES,21,48,0,413163,100%
6461,MLM-TORTILLAS,2,0,0,413163,100%
6462,MLB-IMMERSION_BEER_WORT_CHILLERS,26,87,0,413163,100%
6464,MLB-MANUAL_CREASERS,14,17,0,413163,100%
6465,MLM-OTHER_BOATS,2,2,0,413163,100%
6466,MLM-BICYCLE_BUGLE_HORNS,2,2,0,413163,100%
6467,MLB-RECYCLING_BALER_MACHINES,22,42,0,413163,100%
6470,MLM-TONFAS,2,0,0,413163,100%
6471,MLB-FUEL_INJECTION_RAILS,139,128,0,413163,100%
6472,MLB-KAZOOS,5,0,0,413163,100%
6474,MLB-SEQUINS,10,8,0,413163,100%
6475,MLB-TACTICAL_KNEE_PADS,18,17,0,413163,100%
6477,MLB-OIL_AND_VINEGAR_BOTTLES,27,39,0,413163,100%
6478,MLB-BABY_FOODS,12,22,0,413163,100%
6479,MLB-MOTORCYCLE_FENDER_SUPPORT_BRACKETS,31,52,0,413163,100%
6480,MLB-AUTOMOTIVE_GASOLINE_VAPOR_KITS,28,39,0,413163,100%
6481,MLB-SPORT_AND_SECURITY_WHISTLES,69,118,0,413163,100%
6485,MLB-AUDIO_TUNERS,38,25,0,413163,100%
6487,MLM-KITCHEN_CORN_STRIPPERS,4,13,0,413163,100%
6489,MLB-RECEPTION_BELLS,7,15,0,413163,100%
6490,MLB-DIVING_COMPUTERS,6,10,0,413163,100%
6491,MLB-CHECKOUT_COUNTERS,34,30,0,413163,100%
6492,MLB-EXCAVATORS,84,106,0,413163,100%
6493,MLM-BICYCLE_REPAIR_STANDS,3,7,0,413163,100%
6494,MLB-SWEET_PREMIXES,16,18,0,413163,100%
6495,MLB-FURNITURE_GLIDES,15,10,0,413163,100%
6496,MLB-BATHROOM_HOOKS,40,58,0,413163,100%
6497,MLB-HORSE_RANCH_ROPES,13,29,0,413163,100%
6498,MLB-LAPTOP_POWER_BUTTON_BOARDS,32,36,0,413163,100%
6500,MLM-BEACH_TOYS_SETS,1,3,0,413163,100%
6501,MLM-STAIN_REMOVERS_AND_FABRIC_WHITENERS,3,3,0,413163,100%
6502,MLB-ENGINES,107,115,0,413163,100%
6503,MLB-BABY_JUMPERS,37,48,0,413163,100%
6504,MLB-POTENTIOMETERS,70,97,0,413163,100%
6505,MLB-HORSE_BRAKES,81,108,0,413163,100%
6506,MLB-AUTOMOTIVE_AC_COMPRESSOR_BEARINGS,18,12,0,413163,100%
6507,MLM-CRAFT_GLITTER,2,4,0,413163,100%
6508,MLM-BOX_SPRING_COVERS,1,0,0,413163,100%
6509,MLM-OPTOCOUPLERS,1,1,0,413163,100%
6510,MLM-INDUSTRIAL_MORTISING_MACHINES,1,3,0,413163,100%
6511,MLM-GAME_CONSOLE_CAMERA_MOUNTS,1,0,0,413163,100%
6512,MLB-MITER_BOXES,22,44,0,413163,100%
6513,MLB-MEDICAL_INSTRUMENT_TABLES,13,14,0,413163,100%
6514,MLB-ANTIQUE_BELLS,15,19,0,413163,100%
6515,MLB-QUICK_COUPLERS,43,64,0,413163,100%
6516,MLB-PDA_CHARGERS,3,3,0,413163,100%
6518,MLB-TREKKING_POLES,11,16,0,413163,100%
6519,MLM-AUDIO_TUNERS,2,2,0,413163,100%
6520,MLB-AUTOMOTIVE_SUNROOFS_ACTUATORS,16,13,0,413163,100%
6522,MLB-PRINTER_PICK_UP_ROLLERS,6,3,0,413163,100%
6525,MLB-FIRE_EXTINGUISHERS,46,48,0,413163,100%
6526,MLM-QUENAS,1,3,0,413163,100%
6527,MLM-TOY_PRETEND_PLAY_BLENDERS,2,5,0,413163,100%
6528,MLB-PILATES_AND_YOGA_BLOCKS,21,62,0,413163,100%
6529,MLB-DJEMBES,11,13,0,413163,100%
6530,MLB-WATERPROOF_CAMERA_CASES,47,95,0,413163,100%
6531,MLB-COTTON_CANDY,14,18,0,413163,100%
6532,MLB-MOTOR_GRADERS,28,5,0,413163,100%
6534,MLB-AUTOMOTIVE_TRUNK_CARGO_COVER_SHIELDS,36,50,0,413163,100%
6535,MLB-OFFSET_PRINTERS,44,46,0,413163,100%
6536,MLB-MICROBLADING_RULERS,9,13,0,413163,100%
6537,MLB-CAR_ENGINE_CAMSHAFT_SENSORS,25,29,0,413163,100%
6538,MLB-PORTABLE_CAMPING_SHOWERS,13,23,0,413163,100%
6540,MLB-AUTOMOTIVE_HEADLIGHT_SUPPORT_BRACKETS,19,33,0,413163,100%
6542,MLM-HYDROPONIC_POTS,2,2,0,413163,100%
6544,MLB-PLASMA_CUTTER_CONSUMABLES_SETS,22,22,0,413163,100%
6545,MLM-ELECTRIC_GLUE_GUNS,3,4,0,413163,100%
6546,MLM-DECORATIVE_MASKS,2,1,0,413163,100%
6547,MLB-DECORATIVE_BARRELS,6,5,0,413163,100%
6550,MLB-HORSE_CARTS,35,48,0,413163,100%
6551,MLB-FOOD_AND_DRINK_SYRUPS,19,22,0,413163,100%
6552,MLM-MAT_AND_LIQUID_REPELLENT_ELECTRIC_DEVICES,1,3,0,413163,100%
6554,MLB-DRONE_MODULES,5,3,0,413163,100%
6555,MLM-ENGINES,1,1,0,413163,100%
6556,MLB-POWER_STEERING_FLUID_RESERVOIRS,90,118,0,413163,100%
6558,MLB-CELLPHONE_REPLACEMENT_MICROPHONES,39,69,0,413163,100%
6559,MLB-KIDS_LEARNING_TOWERS,4,3,0,413163,100%
6560,MLB-EROTIC_VIBRATING_BUTTERFLIES,15,25,0,413163,100%
6562,MLB-POWDER_AND_GRAIN_DOSING_MACHINES,9,8,0,413163,100%
6564,MLB-POGS,40,64,0,413163,100%
6566,MLB-TENT_STAKES,14,22,0,413163,100%
6567,MLB-DOOR_AND_WINDOW_AWNINGS_AND_EAVES,42,28,0,413163,100%
6569,MLB-WATERING_CANS,18,22,0,413163,100%
6570,MLB-COMBUSTION_PRESSURE_WASHERS,4,6,0,413163,100%
6571,MLB-INDIVIDUAL_OFFICES_FOR_SALE,26,29,0,413163,100%
6573,MLM-MOTORCYCLE_RADIATORS,1,0,0,413163,100%
6574,MLM-RUGBY_BALLS,1,1,0,413163,100%
6576,MLM-TENT_STAKES,2,3,0,413163,100%
6577,MLB-BOXING_HEADGEARS,21,23,0,413163,100%
6578,MLM-FISHING_ROD_CASES,1,2,0,413163,100%
6579,MLB-POPCORN,19,24,0,413163,100%
6580,MLM-PEN_INK_CARTRIDGES_AND_REFILLS,1,1,0,413163,100%
6581,MLB-ELECTRIC_HOME_HEATERS,50,109,0,413163,100%
6582,MLB-ARCADE_SIMULATORS,21,25,0,413163,100%
6583,MLM-AUTOMOTIVE_ENGINE_ROCKER_ARMS,1,0,0,413163,100%
6584,MLM-TRUNK_HINGES,1,1,0,413163,100%
6585,MLM-WALKIE_TALKIE_COVERS,1,0,0,413163,100%
6586,MLB-SANDWICHES,10,13,0,413163,100%
6587,MLM-TAMPING_RAMMERS,5,3,0,413163,100%
6588,MLB-TOY_IRONING_BOARDS,5,0,0,413163,100%
6590,MLB-GRIPS_AND_OVERGRIPS,28,34,0,413163,100%
6593,MLM-MOTORCYCLE_ENGINE_ROCKER_ARMS,1,1,0,413163,100%
6594,MLM-AUTOMOTIVE_CLUTCH_DISCS,4,4,0,413163,100%
6595,MLM-EROTIC_CORSETS,1,0,0,413163,100%
6597,MLM-EGGS,1,0,0,413163,100%
6598,MLM-PH_METER_BUFFER_SOLUTIONS,1,0,0,413163,100%
6599,MLB-LUGGAGE_TAGS,10,6,0,413163,100%
6600,MLB-CONCRETE_BLOCKS,26,29,0,413163,100%
6601,MLB-ARCADE_MACHINE_BUTTONS,10,9,0,413163,100%
6602,MLB-HUMAN_SKELETON_ANATOMICAL_MODELS,21,37,0,413163,100%
6603,MLM-GARDEN_COMBUSTION_AUGERS,2,2,0,413163,100%
6605,MLB-FLOOR_POLISHERS,21,28,0,413163,100%
6606,MLB-HABERDASHERY_BEADS,31,45,0,413163,100%
6608,MLB-EMBROIDERY_NEEDLES,41,56,0,413163,100%
6609,MLM-MOTORCYCLE_CLUTCH_COVERS,1,0,0,413163,100%
6610,MLM-BEEKEEPING_BOXES,1,2,0,413163,100%
6612,MLB-PENNANTS,24,39,0,413163,100%
6613,MLB-SEWING_THIMBLES,4,2,0,413163,100%
6614,MLM-CONCRETE_MIXER_TRUCKS,2,0,0,413163,100%
6617,MLM-NASAL_WASHERS,1,2,0,413163,100%
6618,MLM-MODEL_SPACE_ROCKETS,3,4,0,413163,100%
6619,MLB-MAGAZINE_HOLDERS,41,46,0,413163,100%
6620,MLB-MOTORCYCLE_DISTRIBUTION_CHAINS,147,148,0,413163,100%
6621,MLM-WINE_CELLARS,3,5,0,413163,100%
6622,MLB-ADULT_MANUAL_TRICYCLES,22,38,0,413163,100%
6623,MLB-3D_PRINTER_FILAMENTS,6,8,0,413163,100%
6624,MLM-INDUSTRIAL_STAPLES,2,4,0,413163,100%
6625,MLM-PET_TOY_KITS,1,0,0,413163,100%
6626,MLM-DIE_STOCKS,1,17,0,413163,100%
6627,MLM-SEEDERS,2,2,0,413163,100%
6628,MLM-NAIL_POLISH_THINNERS,6,16,0,413163,100%
6629,MLB-AUTOMOTIVE_HEADLINERS,26,26,0,413163,100%
6631,MLB-HOME_OFFICE_DESK_ORGANIZERS,22,25,0,413163,100%
6632,MLM-BABY_PUZZLE_PLAY_MATS,1,1,0,413163,100%
6633,MLB-HARDWARE_NUTS,17,12,0,413163,100%
6634,MLB-WADERS,30,36,0,413163,100%
6635,MLB-TOY_WASHING_MACHINES,26,37,0,413163,100%
6636,MLB-MUSICAL_KEYBOARD_CHARGERS,1,2,0,413163,100%
6637,MLM-TOOTHPICK_HOLDERS,1,1,0,413163,100%
6638,MLM-BICYCLE_CHAIN_LUBRICANTS,6,10,0,413163,100%
6639,MLB-OFFICE_RUBBER_BANDS,4,2,0,413163,100%
6640,MLB-AUTOMOTIVE_FUEL_PUMP_STRAINERS,15,11,0,413163,100%
6641,MLB-MUSICAL_TUNERS,16,19,0,413163,100%
6643,MLB-DREAMCATCHERS,31,25,0,413163,100%
6645,MLM-SNAP_RING_PLIERS,1,1,0,413163,100%
6646,MLB-LAUNDRY_BAR_SOAPS,36,34,0,413163,100%
6647,MLB-CASTANETS,3,4,0,413163,100%
6648,MLM-MOTORCYCLE_MAGNETO_ROTORS,2,4,0,413163,100%
6649,MLM-DIVING_KITS,1,1,0,413163,100%
6650,MLB-INDOOR_GROWING_TENTS,57,88,0,413163,100%
6652,MLB-AMBULANCES,16,17,0,413163,100%
6655,MLM-BILL_ACCEPTORS,1,5,0,413163,100%
6656,MLM-BICYCLE_V_BRAKE_SETS,1,1,0,413163,100%
6658,MLB-THERMAL_PADS,23,25,0,413163,100%
6660,MLB-HOSE_CLAMP_PLIERS,14,16,0,413163,100%
6661,MLM-SAKES,1,6,0,413163,100%
6662,MLB-TOY_VEHICLE_BATTERY_CHARGERS,6,8,0,413163,100%
6663,MLB-JUMP_BOXES,24,27,0,413163,100%
6665,MLB-AUTOMOTIVE_SPEEDOMETER_CABLES,30,20,0,413163,100%
6667,MLM-AUTOMOTIVE_HEADLINERS,1,0,0,413163,100%
6668,MLB-QUAILS,23,57,0,413163,100%
6670,MLM-MANUAL_TROLLEYS,1,0,0,413163,100%
6671,MLM-MOTORCYCLE_FENDER_SUPPORT_BRACKETS,1,0,0,413163,100%
6672,MLM-TAMPONS,3,3,0,413163,100%
6675,MLM-VIDEO_CAMERA_CASES_AND_BAGS,2,1,0,413163,100%
6676,MLB-MEDICAL_AND_LABORATORY_AUTOCLAVES,61,84,0,413163,100%
6677,MLM-FABRIC_NAPKINS,1,1,0,413163,100%
6678,MLB-INDUCTIVE_SENSORS,11,12,0,413163,100%
6679,MLM-CARBURETOR_GASKET_SETS,2,1,0,413163,100%
6680,MLB-MITER_SAWS,12,14,0,413163,100%
6681,MLM-TANK_DRUMS,1,1,0,413163,100%
6682,MLB-SKI_AND_SNOWBOARD_GOGGLES,12,10,0,413163,100%
6683,MLM-MEDICINE_BALLS,2,2,0,413163,100%
6684,MLM-FINGER_SKATEBOARDS,2,2,0,413163,100%
6685,MLB-CONSTRUCTION_STIRRUPS,7,12,0,413163,100%
6686,MLB-PROJECTOR_LENSES,12,9,0,413163,100%
6687,MLM-EROTIC_MAGAZINES,1,2,0,413163,100%
6689,MLB-SMARTWATCH_BATTERIES,16,27,0,413163,100%
6690,MLM-DRONE_REMOTE_CONTROLS,2,0,0,413163,100%
6691,MLB-PASTEL_PAINTS,11,22,0,413163,100%
6692,MLB-MASSAGE_SOFAS,42,63,0,413163,100%
6693,MLB-DRONE_BATTERIES,36,72,0,413163,100%
6694,MLB-IRONING_BOARD_CENTERS,10,15,0,413163,100%
6695,MLB-DRONE_PROPELLERS,21,16,0,413163,100%
6696,MLB-VIOLIN_AND_VIOLA_CHINRESTS,5,3,0,413163,100%
6697,MLB-JUICE_DISPENSER_COOLERS,30,26,0,413163,100%
6698,MLM-MOTORCYCLE_CLUTCH_BELLS,1,0,0,413163,100%
6699,MLM-BABY_BISCUITS,1,3,0,413163,100%
6700,MLB-GERMINATION_TRAYS,14,28,0,413163,100%
6701,MLM-DRUM_TENSION_RODS,1,1,0,413163,100%
6703,MLB-TILLERS,25,45,0,413163,100%
6704,MLB-GOLF_SHOES,12,19,0,413163,100%
6705,MLB-MANUAL_LINT_REMOVERS,42,54,0,413163,100%
6708,MLB-EXPANDED_POLYSTYRENE_SHEETS,65,101,0,413163,100%
6709,MLB-EMBROIDERY_MACHINE_FRAMES,1,1,0,413163,100%
6710,MLB-RABBITS,41,64,0,413163,100%
6711,MLB-ENERGY_DRINKS,70,143,0,413163,100%
6712,MLM-DUSTPANS,1,1,0,413163,100%
6713,MLB-MOTORCYCLE_SUMP_GUARDS,39,61,0,413163,100%
6714,MLB-KITCHEN_WINE_VACUUM_PUMPS,9,8,0,413163,100%
6715,MLM-WRINKLE_RELEASERS,3,2,0,413163,100%
6717,MLB-EXTERNAL_BREAST_PROSTHESES,6,12,0,413163,100%
6718,MLM-CLIMBING_DESCENDERS,1,2,0,413163,100%
6719,MLM-KITCHEN_PAPER_TOWELS,1,1,0,413163,100%
6720,MLB-UMBRELLA_STANDS,20,33,0,413163,100%
6722,MLM-REFRIGERATOR_AND_FREEZER_HEATERS,1,0,0,413163,100%
6723,MLM-COOKING_BAGS,1,1,0,413163,100%
6725,MLB-FLOATING_CHLORINE_DISPENSERS,14,15,0,413163,100%
6727,MLB-LENS_CAPS,16,17,0,413163,100%
6728,MLM-SKI_AND_SNOWBOARD_BOOTS,2,2,0,413163,100%
6729,MLB-SEESAWS,9,3,0,413163,100%
6730,MLM-LABORATORY_MICROTUBES,2,2,0,413163,100%
6731,MLM-DIVING_KNIVES,1,4,0,413163,100%
6733,MLM-CHARCOAL,1,2,0,413163,100%
6734,MLM-CONTROL_VINYLS,4,0,0,413163,100%
6736,MLM-BEER_KEGS,1,1,0,413163,100%
6737,MLM-VEHICLE_TRANSMISSION_OILS,1,1,0,413163,100%
6738,MLM-FLASHLIGHT_POUCHES,1,1,0,413163,100%
6739,MLM-HABERDASHERY_FRINGES,1,0,0,413163,100%
6740,MLM-EROTIC_PERFUMES,1,0,0,413163,100%
6742,MLB-MEN_SPORT_SWIMWEAR,65,82,0,413163,100%
6743,MLB-BILLIARD_CUE_TIPS,28,44,0,413163,100%
6745,MLB-OUTDOOR_BLINDS,17,45,0,413163,100%
6746,MLB-LIVESTOCK_DRINKERS,7,10,0,413163,100%
6747,MLB-CNC_MILLING_MACHINES,17,24,0,413163,100%
6748,MLB-DOUBLE_BASSES,17,18,0,413163,100%
6749,MLB-TOOTHPICK_HOLDERS,20,23,0,413163,100%
6750,MLB-SAFETY_CONES,20,28,0,413163,100%
6751,MLB-STUFFED_PET_TOYS,41,161,0,413163,100%
6752,MLM-WOOD_OVENS,1,3,0,413163,100%
6753,MLB-DECORATIVE_PERFUME_BOTTLES,3,1,0,413163,100%
6754,MLB-MEAT_HOOKS,19,23,0,413163,100%
6755,MLB-PERCUSSION_TOMS,22,32,0,413163,100%
6757,MLB-SPORT_PROTECTION_ELBOW_PADS,16,13,0,413163,100%
6759,MLB-BEEKEEPING_BOXES,21,42,0,413163,100%
6761,MLM-GOAL_NETS,1,1,0,413163,100%
6762,MLM-SAFETY_BARRIER_CHAINS,1,0,0,413163,100%
6763,MLB-OTHER_PROPERTIES_FOR_SALE,75,79,0,413163,100%
6764,MLB-OXYGEN_CONCENTRATORS,14,8,0,413163,100%
6765,MLM-INDUSTRIAL_JACKETED_KETTLES,1,1,0,413163,100%
6769,MLM-NAUTICAL_COVERS,1,1,0,413163,100%
6770,MLB-MANUAL_GRAIN_MILLS,32,47,0,413163,100%
6771,MLB-LIVESTOCK_FEEDERS,12,22,0,413163,100%
6772,MLB-COLLECTIBLE_SWORDS,36,48,0,413163,100%
6773,MLB-FIRE_STARTER_FLINTS,40,63,0,413163,100%
6774,MLM-TRAINING_BATTLE_ROPES,1,1,0,413163,100%
6775,MLB-BABY_STROLLER_ORGANIZERS,16,16,0,413163,100%
6776,MLB-POOL_LADDERS,32,79,0,413163,100%
6777,MLB-CAR_AC_EXPANSION_VALVES,39,63,0,413163,100%
6778,MLB-MANUAL_SAUSAGE_STUFFERS,10,8,0,413163,100%
6779,MLB-HAIR_RAZOR_PENS,14,20,0,413163,100%
6780,MLB-MEAT_TENDERIZER_TOOLS,23,49,0,413163,100%
6781,MLB-FISHING_FLOATS_AND_BOBBERS,22,21,0,413163,100%
6782,MLB-MODEL_AIRCRAFT_COMBUSTION_MOTORS,51,53,0,413163,100%
6783,MLB-PARTY_PRINTABLE_KITS,6,5,0,413163,100%
6785,MLB-POOL_CLEANING_NETS,18,13,0,413163,100%
6786,MLB-PIPE_INSULATIONS,17,29,0,413163,100%
6788,MLM-TILE_LEVELER_SPACERS,1,8,0,413163,100%
6789,MLB-INFLATABLE_MOTOR_BOATS,27,32,0,413163,100%
6790,MLB-HAMSTERS,21,37,0,413163,100%
6792,MLB-INSTANT_SOUPS_AND_CREAMS,10,13,0,413163,100%
6793,MLB-ELECTRONIC_ORGANIZERS,10,7,0,413163,100%
6794,MLB-BADMINTON_SETS,2,0,0,413163,100%
6795,MLM-KIDS_BOWLING_GAMES,1,0,0,413163,100%
6796,MLB-CONSTRUCTION_PUTTIES_AND_SPACKELS,19,38,0,413163,100%
6798,MLB-COLD_CUTS_AND_CASINGS,24,22,0,413163,100%
6801,MLB-DIVING_KNIVES,15,23,0,413163,100%
6804,MLM-CALENDARS,1,2,0,413163,100%
6805,MLB-GRANOLA,9,7,0,413163,100%
6806,MLM-MUSICAL_WASHBOARDS,1,0,0,413163,100%
6808,MLB-LIGHT_METERS,6,5,0,413163,100%
6814,MLB-BEACH_BLANKETS_AND_MATS,37,37,0,413163,100%
6816,MLB-ALL_TERRAIN_VEHICLE_WHEELS,3,7,0,413163,100%
6817,MLB-EDGE_BANDING_MACHINES,30,37,0,413163,100%
6818,MLB-REFRIGERATION_STRIP_CURTAINS,23,32,0,413163,100%
6819,MLB-TONER_REFILLS,46,51,0,413163,100%
6820,MLB-BLENDER_LIDS,8,9,0,413163,100%
6821,MLM-TELEPHONE_ANSWERING_MACHINES,1,1,0,413163,100%
6822,MLB-ROWING_MACHINES,35,25,0,413163,100%
6823,MLB-HOME_CLEANING_BRUSHES,15,11,0,413163,100%
6825,MLB-FLOOR_CLOCKS,13,3,0,413163,100%
6826,MLB-PARTY_WIGS,27,31,0,413163,100%
6827,MLB-INSECT_TRAPS,45,83,0,413163,100%
6828,MLB-HYDRAULIC_PRESSES,58,102,0,413163,100%
6829,MLB-WALKIE_TALKIE_BATTERIES,40,44,0,413163,100%
6830,MLB-AIR_CONDITIONER_FILTERS,9,6,0,413163,100%
6831,MLB-TOY_MIXERS,8,7,0,413163,100%
6832,MLB-PERSONAL_CD_PLAYERS,12,16,0,413163,100%
6833,MLB-RADIO_FREQUENCY_MICROPHONES,94,168,0,413163,100%
6834,MLB-AUTOMOTIVE_REAR_AXLES,22,31,0,413163,100%
6835,MLB-WHEELCHAIR_CUSHIONS,25,33,0,413163,100%
6836,MLB-LIVESTOCK_EAR_TAGS,14,15,0,413163,100%
6837,MLB-DOZERS,6,5,0,413163,100%
6838,MLB-POTATO_MASHERS,13,26,0,413163,100%
6840,MLB-WIND_INSTRUMENT_STANDS,8,7,0,413163,100%
6841,MLB-PLAYGROUND_ROUNDABOUTS,5,4,0,413163,100%
6842,MLB-INDUSTRIAL_SILOS,1,1,0,413163,100%
6843,MLB-TRAVEL_DOCUMENT_ORGANIZERS,20,21,0,413163,100%
6844,MLM-POOL_CLEANING_NETS,1,6,0,413163,100%
6845,MLM-GRANOLA,1,2,0,413163,100%
6847,MLB-TONFA_AND_SELF_DEFENSE_BATON_HOLDERS,5,5,0,413163,100%
6848,MLB-CELLOS,19,25,0,413163,100%
6849,MLM-FURNITURE_TRACKS,1,1,0,413163,100%
6850,MLB-BICYCLE_CHAIN_CUTTERS,18,33,0,413163,100%
6851,MLB-FOLDER_AND_EXPANDING_FILE_FILLER_PAPERS,15,15,0,413163,100%
6852,MLB-ORTHODONTIC_WAXES,5,6,0,413163,100%
6853,MLB-MOTORCYCLE_CRANKSHAFTS,48,70,0,413163,100%
6854,MLM-BREAD_BASKETS_AND_BOXES,1,2,0,413163,100%
6855,MLB-VEHICLE_OIL_FILTER_WRENCHES,22,72,0,413163,100%
6857,MLM-TOY_MICROWAVES,2,4,0,413163,100%
6858,MLM-BUSINESS_TELEPHONE_SYSTEMS,1,0,0,413163,100%
6859,MLM-WORK_JACKETS,1,8,0,413163,100%
6860,MLB-HAND_FILES,118,165,0,413163,100%
6861,MLB-EAR_WAX_REMOVERS,29,52,0,413163,100%
6862,MLB-MOTORCYCLE_RUBBER_DAMPERS,25,28,0,413163,100%
6863,MLB-SHOOTING_STICKS,19,19,0,413163,100%
6865,MLB-GROOVE_JOINT_PLIERS,19,17,0,413163,100%
6866,MLB-GAS_LAWN_MOWERS,10,8,0,413163,100%
6867,MLB-AFTER_SUNS,15,10,0,413163,100%
6868,MLB-DATA_COLLECTORS,24,17,0,413163,100%
6869,MLB-AQUARIUM_AIR_PUMPS,53,84,0,413163,100%
6871,MLB-BABY_FEEDING_SETS,19,30,0,413163,100%
6872,MLM-KAZOOS,2,2,0,413163,100%
6873,MLB-TRUNK_HINGES,25,36,0,413163,100%
6874,MLB-URINALS,15,18,0,413163,100%
6875,MLB-DOG_SOAPS,11,9,0,413163,100%
6876,MLM-INFLATABLE_PILLOWS,1,0,0,413163,100%
6877,MLB-INDUCTION_CAP_SEALERS,2,4,0,413163,100%
6878,MLB-DRY_BAGS,9,5,0,413163,100%
6879,MLB-PORTABLE_GAME_CONSOLE_REPLACEMENT_BUTTONS,12,16,0,413163,100%
6880,MLB-AUTOMOTIVE_BATTERY_JUMPER_CABLES,13,8,0,413163,100%
6881,MLB-GLASS_BLOCKS,14,21,0,413163,100%
6882,MLM-BABY_BOTTLE_TOTE_BAGS,1,2,0,413163,100%
6883,MLB-ENGINE_PISTON_AND_LINER_KITS,8,9,0,413163,100%
6884,MLB-SAFETY_PINS,1,2,0,413163,100%
6885,MLB-EXTERNAL_DEFIBRILLATORS,25,25,0,413163,100%
6886,MLB-TALCUMS,47,59,0,413163,100%
6889,MLB-TACTICAL_HELMETS,27,40,0,413163,100%
6891,MLB-BEER_BREWING_YEASTS,9,3,0,413163,100%
6892,MLB-ANTI_PANIC_BARS,1,2,0,413163,100%
6893,MLB-MANUAL_EDGE_BANDING_TRIMMERS,15,26,0,413163,100%
6895,MLB-SHEET_FOLDING_MACHINES,32,33,0,413163,100%
6896,MLB-BDSM_RESTRAINTS,6,2,0,413163,100%
6898,MLB-DANCE_MATS,17,28,0,413163,100%
6899,MLB-PAINT_THINNERS_AND_SOLVENTS,1,1,0,413163,100%
6900,MLB-HOME_ROD_BRACKETS,14,12,0,413163,100%
6901,MLB-MOTORCYCLE_ALTERNATOR_STATOR_COVER_GASKETS,15,10,0,413163,100%
6902,MLB-BLOCK_MAKING_MACHINES,42,75,0,413163,100%
6903,MLB-PET_DIAPERS,28,41,0,413163,100%
6905,MLB-PARKING_BLOCKS,33,31,0,413163,100%
6908,MLB-HOT_DOG_MACHINES,4,8,0,413163,100%
6909,MLB-TRUMPET_MOUTHPIECES,21,29,0,413163,100%
6910,MLB-MOTORCYCLE_RADIATOR_PROTECTORS,12,14,0,413163,100%
6911,MLB-NON_SLIP_TAPES,49,70,0,413163,100%
6912,MLB-EXHAUST_MANIFOLD_GASKET_SETS,27,19,0,413163,100%
6913,MLM-LANYARDS,1,1,0,413163,100%
6914,MLM-VEHICLE_COATING_PRODUCTS,2,2,0,413163,100%
6915,MLB-BIRDHOUSES,19,22,0,413163,100%
6916,MLM-DICE,1,1,0,413163,100%
6917,MLM-READING_STANDS,1,3,0,413163,100%
6918,MLM-MANUAL_DOUGH_DIVIDERS,1,1,0,413163,100%
6919,MLB-PULPERS,16,29,0,413163,100%
6920,MLB-MANUAL_CLOTH_FOLDING_BOARDS,12,16,0,413163,100%
6924,MLB-HONEY_EXTRACTORS,17,32,0,413163,100%
6925,MLB-CRUMB_SWEEPERS,2,1,0,413163,100%
6926,MLB-RUBBER_STAMP_INK_REFILLS,19,36,0,413163,100%
6927,MLB-SHRINK_TUNNELS,3,2,0,413163,100%
6928,MLB-GARTER_BELTS,27,39,0,413163,100%
6929,MLB-TATTOO_ARMRESTS,20,26,0,413163,100%
6930,MLB-CNC_MACHINING_CENTERS,16,11,0,413163,100%
6932,MLB-CAMERA_SCREEN_PROTECTORS,14,17,0,413163,100%
6933,MLM-VEHICLE_MECHANICAL_SERVICES,1,0,0,413163,100%
6934,MLB-OCARINAS,19,14,0,413163,100%
6936,MLB-ECG_MACHINES,21,34,0,413163,100%
6937,MLB-PUNCHING_BAGS_SUPPORTS,44,84,0,413163,100%
6938,MLB-DEBRIS_BAGS,9,11,0,413163,100%
6940,MLB-PRINTER_SPARE_CONTROL_PANELS,10,9,0,413163,100%
6941,MLB-FOOD_SLICERS,69,73,0,413163,100%
6943,MLB-TAMPONS,5,7,0,413163,100%
6944,MLB-SNAP_OFF_UTILITY_KNIVES,68,97,0,413163,100%
6945,MLB-RUNES,5,0,0,413163,100%
6946,MLB-XYLOPHONES_AND_METALLOPHONES,16,180,0,413163,100%
6947,MLB-DIAL_INDICATORS,40,54,0,413163,100%
6948,MLB-BUILT_IN_BRAZIERS,11,41,0,413163,100%
6949,MLB-AUTOMOTIVE_RUST_INHIBITORS,13,15,0,413163,100%
6950,MLM-PARKING_BLOCKS,2,3,0,413163,100%
6952,MLM-TOY_CELLPHONES,3,3,0,413163,100%
6953,MLB-VIOLAS,11,18,0,413163,100%
6954,MLM-BICYCLE_TIRE_REPAIR_KITS,1,1,0,413163,100%
6957,MLB-ROASTING_STICKS,41,66,0,413163,100%
6958,MLB-AUTOMOTIVE_ASHTRAYS,107,90,0,413163,100%
6959,MLB-SCHOOL_KITS,39,57,0,413163,100%
6960,MLB-DOUBLE_CHIN_REDUCER_DEVICES,3,3,0,413163,100%
6961,MLB-LIQUOR_DECANTERS,7,1,0,413163,100%
6962,MLB-TV_REMOTE_CONTROL_COVERS,36,52,0,413163,100%
6963,MLB-LAPTOP_REPLACEMENT_INTERNAL_SPEAKERS,25,29,0,413163,100%
6964,MLB-HABERDASHERY_STUDS,13,9,0,413163,100%
6965,MLB-FUEL_HOSES,9,7,0,413163,100%
6966,MLB-DRONES_FLEX_CABLES,5,2,0,413163,100%
6967,MLB-SERVICE_CARTS,14,11,0,413163,100%
6971,MLB-FOOD_DEHYDRATORS,21,10,0,413163,100%
6972,MLB-MOTORCYCLE_FILTER_KITS,10,6,0,413163,100%
6973,MLB-EFFECTS_MACHINE_FLUIDS,13,17,0,413163,100%
6974,MLM-RFID_TAGS,3,4,0,413163,100%
6975,MLB-BUTTER,19,20,0,413163,100%
6977,MLB-PARAMOTORS,40,75,0,413163,100%
6978,MLB-MANUAL_CAPSULE_FILLERS,13,31,0,413163,100%
6979,MLB-MIRROR_BALLS,34,67,0,413163,100%
6980,MLB-WASHING_AND_DRYER_MACHINE_BEARINGS,4,6,0,413163,100%
6981,MLB-TACTICAL_PANTS,10,8,0,413163,100%
6982,MLB-CEILING_LIGHTS,4,3,0,413163,100%
6983,MLB-CUPCAKES,25,34,0,413163,100%
6984,MLB-GAME_CONSOLE_MEDIA_REMOTE_CONTROLS,18,22,0,413163,100%
6985,MLM-PHOTO_CUTTERS,1,1,0,413163,100%
6986,MLM-LAUNDRY_WASH_BALLS,1,3,0,413163,100%
6987,MLB-PASTAS,21,21,0,413163,100%
6991,MLB-AUTOMOTIVE_ROOF_CARGO_BASKETS,27,38,0,413163,100%
6992,MLB-ELECTRIC_OUTBOARD_MOTORS,19,31,0,413163,100%
6993,MLB-NAUTICAL_IGNITION_COILS,13,9,0,413163,100%
6994,MLB-DOG_AND_CAT_SANITARY_PANTIES,10,26,0,413163,100%
6995,MLB-COFFEE_AND_FOOD_DECORATING_PENS,11,15,0,413163,100%
6996,MLB-HANDBALL_BALLS,14,8,0,413163,100%
6997,MLB-TICKET_NUMBER_DISPENSERS,11,23,0,413163,100%
6998,MLB-DIGITAL_TIRE_GAUGES,10,13,0,413163,100%
7000,MLB-BDSM_HANDCUFFS,15,22,0,413163,100%
7001,MLB-PLASMA_CUTTERS,53,81,0,413163,100%
7002,MLB-TV_BUTTON_BOARDS,5,10,0,413163,100%
7003,MLB-QUIVERS,12,3,0,413163,100%
7005,MLB-EASELS,19,23,0,413163,100%
7006,MLB-BICYCLE_DISC_BRAKE_ADAPTERS,10,18,0,413163,100%
7007,MLB-STACKABLE_BINS,20,24,0,413163,100%
7008,MLB-GOLF_BALLS,7,7,0,413163,100%
7009,MLB-INSECT_KILLER_LIGHTS,4,9,0,413163,100%
7010,MLB-AUDIO_CASSETTES,4,3,0,413163,100%
7011,MLB-WASHING_MACHINE_SHOCK_ABSORBERS,10,17,0,413163,100%
7013,MLB-EROTIC_MALE_UNDERWEAR,6,2,0,413163,100%
7014,MLB-PHOTOCOPIER_DEVELOPERS,2,2,0,413163,100%
7015,MLB-EROTIC_CANDLES,3,2,0,413163,100%
7017,MLM-WASHING_MACHINE_PULLEYS,1,1,0,413163,100%
7018,MLM-COFFEE_READY_TO_DRINK,1,1,0,413163,100%
7019,MLM-AUTOMOTIVE_CAT_EYE_REFLECTORS,1,0,0,413163,100%
7020,MLB-RFID_SUPPLY_CLONERS,12,11,0,413163,100%
7021,MLB-DISPOSABLE_SLIPPERS_AND_FLIP_FLOPS,15,19,0,413163,100%
7023,MLB-ANTIBACTERIAL_GELS,11,13,0,413163,100%
7024,MLB-BROOM_HOLDERS,5,3,0,413163,100%
7025,MLB-PROXIMITY_CARDS,10,7,0,413163,100%
7026,MLB-DRONE_REMOTE_CONTROLS,28,69,0,413163,100%
7027,MLB-CAMERA_CRANES,18,17,0,413163,100%
7028,MLM-TRAINING_POLES,1,1,0,413163,100%
7029,MLB-PROVOLETA_PLATES,16,14,0,413163,100%
7030,MLB-PIPE_CUTTERS,27,37,0,413163,100%
7031,MLB-STIMULATING_PILLS_AND_CAPSULES,28,50,0,413163,100%
7032,MLB-CELLPHONE_REPLACEMENT_KEYBOARDS,9,5,0,413163,100%
7034,MLB-HAIR_REMOVAL_SPRINGS,3,1,0,413163,100%
7035,MLB-DRONE_ANTENNAS,6,7,0,413163,100%
7036,MLB-KIDS_FAUCET_EXTENDERS,3,8,0,413163,100%
7038,MLB-HOPS,16,18,0,413163,100%
7039,MLB-CAT_HOUSES,37,47,0,413163,100%
7040,MLB-BICYCLE_DISC_BRAKE_CALIPERS,15,20,0,413163,100%
7041,MLB-SECURITY_MONITORS,9,34,0,413163,100%
7042,MLB-EROTIC_BALLS,27,32,0,413163,100%
7043,MLB-ENGINE_COOLING_FAN_CLUTCHES,14,13,0,413163,100%
7044,MLB-LAWN_MOWER_BLADES,14,31,0,413163,100%
7045,MLB-COMPUTER_DIAGNOSTIC_CARDS,21,15,0,413163,100%
7046,MLB-POOL_HOSES,15,34,0,413163,100%
7048,MLB-REFLECTIVE_VESTS,22,27,0,413163,100%
7049,MLB-PDA_REPLACEMENT_SCREENS,17,15,0,413163,100%
7051,MLB-APPETIZER_PICKS,13,22,0,413163,100%
7052,MLM-AFTER_SUNS,1,1,0,413163,100%
7053,MLM-MOTORCYCLE_ALTERNATOR_STATOR_COVERS,2,0,0,413163,100%
7054,MLB-FLIP_FLOP_STAMPING_MACHINES,4,4,0,413163,100%
7057,MLB-HABERDASHERY_HOOK_AND_LOOP_FASTENERS,11,15,0,413163,100%
7058,MLM-CHALKBOARD_AND_WHITEBOARD_ERASERS,2,2,0,413163,100%
7059,MLB-TOWABLE_TUBES,22,34,0,413163,100%
7061,MLM-REFRIGERATOR_AND_FREEZER_LIGHT_SWITCHES,1,1,0,413163,100%
7062,MLM-EGG_SEPARATORS,2,2,0,413163,100%
7063,MLB-MOTOR_COIL_WINDING_MACHINES,4,4,0,413163,100%
7064,MLB-DRONE_LANDING_GEARS,15,13,0,413163,100%
7065,MLB-TEA_STORAGE_CHESTS,7,11,0,413163,100%
7066,MLB-DIVING_REGULATORS,22,35,0,413163,100%
7067,MLB-GAS_FIREPLACES,12,17,0,413163,100%
7069,MLB-PORTABLE_GAME_CONSOLE_CASES,17,23,0,413163,100%
7070,MLB-ALKALINE_WATER_STICKS,17,29,0,413163,100%
7071,MLB-PARTY_HEADBANDS_CROWNS_AND_TIARAS,12,13,0,413163,100%
7072,MLB-VOLUMETRIC_FILLERS,19,17,0,413163,100%
7073,MLB-BASKETBALL_KITS,11,28,0,413163,100%
7074,MLM-RADIO_FREQUENCY_AMPLIFIERS_AND_TRANSMITTERS,2,1,0,413163,100%
7075,MLB-ANIMAL_PASTURE_BALES,7,11,0,413163,100%
7076,MLB-MODEL_NAVAL_BOATS,14,13,0,413163,100%
7077,MLM-ACTION_CAMERA_DOMES,1,3,0,413163,100%
7078,MLM-TWEEZERS,1,1,0,413163,100%
7079,MLB-DRONE_PROPELLER_GUARDS,9,5,0,413163,100%
7081,MLB-FIRST_AID_KITS,23,52,0,413163,100%
7082,MLB-TIMBALES,9,8,0,413163,100%
7083,MLB-AQUARIUM_SKIMMERS,43,73,0,413163,100%
7084,MLB-BABY_BOTTLE_WARMERS,19,30,0,413163,100%
7085,MLM-TELEPHONE_FILTERS,1,0,0,413163,100%
7086,MLB-KITCHEN_MORTARS,28,49,0,413163,100%
7087,MLB-ELECTRICAL_BALLASTS,14,18,0,413163,100%
7088,MLB-POKER_CHIPS,11,15,0,413163,100%
7089,MLB-READY_TO_DRINK_COCKTAILS,30,36,0,413163,100%
7090,MLB-MOTORCYCLE_ALTERNATOR_STATOR_COVERS,14,10,0,413163,100%
7091,MLB-INTERDENTAL_BRUSHES,22,30,0,413163,100%
7092,MLB-GRAIN_CARTS,15,18,0,413163,100%
7093,MLB-DIGITAL_CENTRIFUGE_MACHINES,5,2,0,413163,100%
7094,MLB-TRAINING_POLES,2,1,0,413163,100%
7095,MLB-BEER_BOTTLES_AND_GROWLERS,8,13,0,413163,100%
7096,MLB-ENGINE_COMPRESSION_TESTERS,17,14,0,413163,100%
7097,MLM-KEYBOARD_AND_PIANO_BENCHES,2,2,0,413163,100%
7098,MLB-PNEUMATIC_VALVES,16,19,0,413163,100%
7100,MLB-AIR_PURIFIERS,22,30,0,413163,100%
7102,MLB-RAMEKINS,34,31,0,413163,100%
7103,MLB-LATHE_CHUCKS,22,26,0,413163,100%
7104,MLB-NAUTICAL_SEAT_BASES,7,4,0,413163,100%
7105,MLB-ALLERGY_MEDICINES,6,0,0,413163,100%
7106,MLB-SKI_AND_SNOWBOARD_BOOTS,5,6,0,413163,100%
7108,MLB-FIBER_OPTIC_DISTRIBUTION_BOXES,10,12,0,413163,100%
7109,MLM-TACTICAL_BOARDS,1,1,0,413163,100%
7110,MLM-WATCH_RINGS,1,1,0,413163,100%
7111,MLM-CLIMBING_PULLEYS,1,1,0,413163,100%
7112,MLB-ANTI_STATIC_PLIERS,14,14,0,413163,100%
7113,MLB-FIBER_OPTIC_FUSION_SPLICERS,18,28,0,413163,100%
7114,MLB-ROWING_PADDLES,7,4,0,413163,100%
7115,MLM-BOLT_CUTTERS,1,2,0,413163,100%
7116,MLB-MOTORCYCLE_CHAIN_TENSIONERS,4,3,0,413163,100%
7117,MLB-DOG_FRISBEES,5,4,0,413163,100%
7118,MLB-COMPUTER_CLEANING_KITS,12,9,0,413163,100%
7119,MLB-COMPUTER_MOTION_CONTROLLERS,2,2,0,413163,100%
7120,MLB-AUTOMOTIVE_RAG_JOINTS,9,8,0,413163,100%
7121,MLB-ACCORDION_CASES_AND_BAGS,15,63,0,413163,100%
7122,MLB-LENS_HOODS,26,37,0,413163,100%
7123,MLB-DRINKING_GLASS_RIMMERS,4,2,0,413163,100%
7124,MLB-ANTIQUE_CASH_REGISTERS,10,15,0,413163,100%
7125,MLB-CARD_PRINTERS,10,10,0,413163,100%
7126,MLB-PEN_INK_CARTRIDGES_AND_REFILLS,23,14,0,413163,100%
7127,MLB-NETWORK_CABLE_ADAPTERS,21,42,0,413163,100%
7128,MLB-RFID_TAGS,1,0,0,413163,100%
7129,MLB-PET_TOY_KITS,50,126,0,413163,100%
7130,MLB-INDUSTRIAL_DUST_COLLECTORS,6,8,0,413163,100%
7132,MLM-MOTOR_GRADERS,1,1,0,413163,100%
7133,MLB-VEHICLE_FUEL_INJECTOR_EMULATORS,23,24,0,413163,100%
7134,MLB-WIRE_STRIPPER_MACHINES,9,20,0,413163,100%
7135,MLB-AUTOMOTIVE_GLOVE_BOXES,31,22,0,413163,100%
7137,MLB-ANTIQUE_TAPE_RECORDERS,12,13,0,413163,100%
7138,MLB-SHOE_REPLACEMENT_CLEATS,9,13,0,413163,100%
7139,MLB-RING_SIZERS,19,32,0,413163,100%
7140,MLB-WAREHOUSES_FOR_SALE,15,13,0,413163,100%
7141,MLB-EGG_SLICERS,7,5,0,413163,100%
7142,MLM-NETWORK_PLUG_COVERS,3,2,0,413163,100%
7145,MLB-STORE_SHOPPING_CART_SAFETY_LOCK_CARDS,6,6,0,413163,100%
7146,MLM-CONSTRUCTION_STILTS,2,0,0,413163,100%
7147,MLB-EAR_COTTON_SWABS,14,18,0,413163,100%
7148,MLB-CRYPTOCURRENCY_HARDWARE_WALLETS,9,3,0,413163,100%
7151,MLB-CAR_MULTIMEDIA_SYSTEMS,1,1,0,413163,100%
7152,MLB-KITCHEN_WHEEL_CUTTERS,6,3,0,413163,100%
7153,MLM-CUT_OFF_WHEELS,1,0,0,413163,100%
7154,MLB-FOLDING_CAMPING_TABLES_AND_CHAIRS_SETS,12,20,0,413163,100%
7155,MLB-PRINTER_SPARE_CARRIAGE_UNITS,13,18,0,413163,100%
7156,MLB-GRAMOPHONES,53,97,0,413163,100%
7157,MLM-DARKROOM_ENLARGERS,1,0,0,413163,100%
7160,MLM-ELECTRIC_KNIVES,1,1,0,413163,100%
7161,MLM-PROMOTIONAL_UMBRELLAS,1,1,0,413163,100%
7162,MLM-WIRE_ROPE_CLIPS,1,3,0,413163,100%
7163,MLB-VEHICLE_CLUTCH_CABLES,6,4,0,413163,100%
7164,MLB-AUTOMOTIVE_TRIPOD_JOINT_SPIDERS,9,10,0,413163,100%
7165,MLB-LAUNDRY_WASH_BALLS,14,17,0,413163,100%
7166,MLB-FIBER_OPTIC_SPLICE_CLOSURES,4,2,0,413163,100%
7167,MLM-COMMUNICATION_TOWERS,3,7,0,413163,100%
7168,MLB-GROIN_GUARDS,12,13,0,413163,100%
7169,MLM-TELEPHONY_CARDS,2,0,0,413163,100%
7170,MLB-EROTIC_BOOKS,15,13,0,413163,100%
7171,MLM-GATE_GEAR_RACKS,1,0,0,413163,100%
7172,MLB-MAKEUP_BRUSH_TEXTURED_CLEANERS,6,6,0,413163,100%
7173,MLM-MEDICAL_HOSES,1,1,0,413163,100%
7174,MLM-ELECTRIC_OUTBOARD_MOTORS,2,1,0,413163,100%
7175,MLM-AUTOMOTIVE_OBD_CONNECTORS,1,0,0,413163,100%
7177,MLB-CELLPHONE_PRINTERS,15,29,0,413163,100%
7178,MLB-DOG_LIFE_JACKETS,21,16,0,413163,100%
7179,MLB-ALL_TERRAIN_VEHICLE_TIRES,9,10,0,413163,100%
7180,MLB-GARDEN_SHEDS,3,3,0,413163,100%
7182,MLB-DRUM_CLAMPS,20,32,0,413163,100%
7183,MLB-BABY_REPELLENT_BUTTONS,31,63,0,413163,100%
7184,MLB-BREAKFASTS_AND_AFTERNOON_TEAS,11,18,0,413163,100%
7185,MLB-AUTOMOTIVE_NITROUS_OXIDE_SYSTEMS,6,16,0,413163,100%
7187,MLB-CEREAL_DISPENSERS,26,43,0,413163,100%
7188,MLB-GAME_CONSOLE_POWER_RESET_BOARDS,13,11,0,413163,100%
7189,MLB-FLIP_FLOP_STRAPS,12,16,0,413163,100%
7190,MLB-TURNTABLE_NEEDLES,8,8,0,413163,100%
7191,MLB-BOXING_SPEED_BAGS,7,11,0,413163,100%
7193,MLB-WALL_LIGHT_SWITCHES,14,21,0,413163,100%
7194,MLB-PRINTER_SPARE_TRACTOR_UNITS,17,17,0,413163,100%
7195,MLM-HENTAI_MOVIES,3,0,0,413163,100%
7196,MLB-SALTY_PREMIXES,4,5,0,413163,100%
7197,MLB-METAL_WIRES,5,4,0,413163,100%
7198,MLB-COLLECTIBLE_MATCHBOXES,3,3,0,413163,100%
7199,MLB-STAMP_PADS,18,24,0,413163,100%
7200,MLB-FLIP_FLOP_CUTTING_RULE_DIES,12,15,0,413163,100%
7201,MLB-STAIN_REMOVERS_AND_FABRIC_WHITENERS,24,26,0,413163,100%
7202,MLM-ENGINE_PISTON_AND_LINER_KITS,1,1,0,413163,100%
7203,MLB-DIPS_AND_SPREADS,4,23,0,413163,100%
7204,MLB-CLUTCH_FORKS,44,47,0,413163,100%
7205,MLB-HORSE_HALTERS,27,28,0,413163,100%
7206,MLB-AUTOMOTIVE_ENGINE_TIMING_CHAINS,18,19,0,413163,100%
7207,MLB-DRAFTING_TEMPLATES,6,11,0,413163,100%
7208,MLB-TAMBORIMS,28,37,0,413163,100%
7209,MLB-BICYCLE_WHEEL_AXLES,20,27,0,413163,100%
7210,MLB-SCREEN_PRINTING_MACHINES,5,17,0,413163,100%
7211,MLB-NAUTICAL_ANCHORS,34,52,0,413163,100%
7213,MLB-KITESURF_BOARDS,7,8,0,413163,100%
7215,MLB-DOG_POOP_BAG_DISPENSERS,3,4,0,413163,100%
7216,MLB-DOG_TOY_BONES,22,28,0,413163,100%
7217,MLB-STOLES,15,26,0,413163,100%
7218,MLB-COCKTAIL_JIGGERS,7,1,0,413163,100%
7222,MLB-CAMERA_SHOE_MOUNT_ADAPTERS,2,6,0,413163,100%
7223,MLB-PAINT_TONERS,2,1,0,413163,100%
7224,MLB-SPORT_SKIRTS,3,5,0,413163,100%
7225,MLB-HENTAI_FIGURES,4,2,0,413163,100%
7226,MLB-MANUAL_SUGAR_CANE_JUICERS,11,16,0,413163,100%
7227,MLB-HAIRDRESSING_FLOOR_AND_WALL_HAIR_STEAMERS,3,0,0,413163,100%
7228,MLB-WATER_DISPENSER_BOTTLE_COVERS,46,78,0,413163,100%
7230,MLB-AUTOMOTIVE_DEFROSTER_SWITCHES,29,33,0,413163,100%
7231,MLB-DIVING_BELTS,4,4,0,413163,100%
7232,MLB-HYDROPONIC_NUTRIENTS,15,25,0,413163,100%
7233,MLB-POWER_TROWELS,6,13,0,413163,100%
7234,MLB-SHAVING_BRUSHES,13,9,0,413163,100%
7235,MLB-SERVER_RACKS,29,28,0,413163,100%
7236,MLB-TENNIS_BAGS,14,7,0,413163,100%
7237,MLB-DRAGGING_TOYS,17,23,0,413163,100%
7238,MLB-WRISTWATCH_BUCKLES,7,15,0,413163,100%
7239,MLB-WRINKLE_RELEASERS,2,1,0,413163,100%
7240,MLB-FAN_CAPACITORS,12,4,0,413163,100%
7241,MLB-FOOD_PACKAGING_BOXES,76,103,0,413163,100%
7242,MLM-COOKING_CREAMS,1,20,0,413163,100%
7243,MLB-GAME_CONSOLE_ACCESSORIES_KITS,5,1,0,413163,100%
7245,MLB-INSTANT_NOODLES,9,17,0,413163,100%
7246,MLB-METAL_FOUNDRY_FURNACES,6,8,0,413163,100%
7247,MLB-HAIRDRESSING_CLIPS,26,40,0,413163,100%
7248,MLB-FIREWOOD,23,25,0,413163,100%
7249,MLB-AUTOMOTIVE_BRAKE_FORCE_REGULATORS,22,30,0,413163,100%
7250,MLM-MODEL_AIRCRAFT_ELECTRIC_MOTORS,1,1,0,413163,100%
7251,MLB-BABY_TOOTHBRUSHES,8,6,0,413163,100%
7252,MLB-PDA,9,4,0,413163,100%
7254,MLB-FLOPPY_DRIVES,5,3,0,413163,100%
7255,MLB-PLANES,31,60,0,413163,100%
7256,MLB-CROWBARS,10,9,0,413163,100%
7257,MLB-COUNTERFEIT_MONEY_DETECTOR_PENS,7,8,0,413163,100%
7258,MLM-FRY_DUMP_STATIONS,1,0,0,413163,100%
7259,MLB-ATABAQUES,10,17,0,413163,100%
7261,MLB-PRINTER_MOTHERBOARDS,9,37,0,413163,100%
7263,MLB-PRINTER_SERVERS,19,25,0,413163,100%
7264,MLB-MOTORCYCLE_CLUTCH_KITS,10,10,0,413163,100%
7265,MLB-EDGE_PROTECTORS,8,10,0,413163,100%
7266,MLB-OIL_PAINTS,13,24,0,413163,100%
7267,MLB-PRINTER_TRANSPARENCIES,9,14,0,413163,100%
7268,MLB-BICYCLE_REPAIR_STANDS,5,4,0,413163,100%
7270,MLB-AIR_CONDITIONER_COVERS,3,2,0,413163,100%
7271,MLB-ESOTERIC_PENDULUMS,22,36,0,413163,100%
7272,MLM-ROASTING_STICKS,1,4,0,413163,100%
7273,MLB-SPARK_PLUG_WRENCHES,19,51,0,413163,100%
7274,MLB-MANICURE_PRACTICE_HANDS_AND_FINGERS,24,51,0,413163,100%
7275,MLB-NEOPRENE_SOCKS,5,6,0,413163,100%
7276,MLB-SPORTS_DRINKS,12,23,0,413163,100%
7278,MLB-AIR_CONDITIONER_MOTORS,17,16,0,413163,100%
7279,MLB-INDUSTRIAL_GEARBOXES,8,8,0,413163,100%
7280,MLB-BDSM_MASKS,3,1,0,413163,100%
7281,MLB-SEWING_BOXES,12,16,0,413163,100%
7282,MLB-RADIOFREQUENCY_POWER_SUPPLIES,12,13,0,413163,100%
7283,MLB-PORTION_MARKERS,10,26,0,413163,100%
7284,MLB-JAMS,19,25,0,413163,100%
7285,MLB-COCKROACHES,6,10,0,413163,100%
7286,MLB-INFLATABLE_PILLOWS,20,24,0,413163,100%
7287,MLB-BLEACHES,3,7,0,413163,100%
7288,MLB-TELESCOPIC_POST_SHORES,21,40,0,413163,100%
7289,MLB-GYM_HANDLES,13,10,0,413163,100%
7290,MLB-SAUNA_CABINS,5,6,0,413163,100%
7291,MLB-ELECTRIC_PAPER_CUTTERS,9,20,0,413163,100%
7292,MLB-TACTICAL_FANNY_PACKS,5,5,0,413163,100%
7293,MLB-POLYWIRE_THREADS,18,14,0,413163,100%
7294,MLB-AUTOMOTIVE_AC_COMPRESSOR_CONTROL_VALVES,16,21,0,413163,100%
7295,MLB-PLOW_DISC_BURNERS,17,22,0,413163,100%
7296,MLB-OIL_AND_VINEGAR_SPRAYERS,1,2,0,413163,100%
7297,MLB-RADIO_FREQUENCY_AMPLIFIERS_AND_TRANSMITTERS,19,42,0,413163,100%
7298,MLB-DESICCANT_BAGS,7,2,0,413163,100%
7299,MLB-FORCE_GAUGES,12,12,0,413163,100%
7300,MLB-TOILET_SEAT_COVERS,6,7,0,413163,100%
7301,MLB-MEDICAL_GEL_PACKS,2,6,0,413163,100%
7302,MLB-BUCKETS_AND_BASINS,19,16,0,413163,100%
7303,MLB-FISH_TANK_CO2_DIFFUSERS,55,73,0,413163,100%
7304,MLB-BRAKE_LIGHT_SWITCHES,11,8,0,413163,100%
7306,MLM-AUDIO_CASSETTES,1,0,0,413163,100%
7307,MLB-COFFEE_VENDING_MACHINES,7,13,0,413163,100%
7308,MLB-EQUESTRIAN_SPORT_HELMETS,4,13,0,413163,100%
7310,MLB-TOY_PRETEND_PLAY_BLENDERS,19,27,0,413163,100%
7311,MLB-MICROWAVE_OMELETTE_MAKERS,11,7,0,413163,100%
7312,MLB-BOOKMARKS,9,6,0,413163,100%
7313,MLB-APERITIFS,11,16,0,413163,100%
7314,MLB-COOKIE_STAMPS,4,2,0,413163,100%
7315,MLB-BICYCLE_BASKETS,38,47,0,413163,100%
7316,MLB-CASTER_BOARDS,7,18,0,413163,100%
7317,MLB-WAKEBOARD_AND_WATER_SKI_HANDLES_AND_ROPES,7,4,0,413163,100%
7318,MLB-CLUTCH_BEARINGS,34,51,0,413163,100%
7319,MLB-MANDOLINS,20,22,0,413163,100%
7320,MLB-TOILET_LID_AND_BIDET_COVERS,3,2,0,413163,100%
7321,MLB-KARTS,17,26,0,413163,100%
7322,MLB-3D_PRINTER_HOTENDS,3,3,0,413163,100%
7323,MLB-INSPECTION_CHAMBER_RISERS,3,2,0,413163,100%
7324,MLB-PASTEURIZERS,2,0,0,413163,100%
7325,MLB-GROUND_RESISTANCE_METERS,21,44,0,413163,100%
7326,MLB-DRUM_TENSION_RODS,8,7,0,413163,100%
7327,MLB-ESTHETIC_ELECTROPORATORS,9,18,0,413163,100%
7329,MLB-GAS_HOT_DOG_MACHINES,1,1,0,413163,100%
7330,MLB-CAMERA_REPLACEMENT_DISPLAYS,6,3,0,413163,100%
7331,MLB-CPR_TRAINING_MANIKINS,8,5,0,413163,100%
7332,MLB-ENGINE_OIL_PUMP_PICKUP_TUBES,11,21,0,413163,100%
7333,MLM-STUN_GUN_FLASHLIGHTS,1,1,0,413163,100%
7334,MLB-CLOTHESPINS,28,32,0,413163,100%
7335,MLB-TERRARIUM_HEATERS,5,7,0,413163,100%
7337,MLB-SAKES,8,17,0,413163,100%
7339,MLB-PLUNGERS,12,10,0,413163,100%
7340,MLB-PIPE_THREADING_MACHINES,12,12,0,413163,100%
7341,MLB-GOLF_BAGS,2,3,0,413163,100%
7342,MLB-WINDSOCKS,18,27,0,413163,100%
7343,MLB-AGOGOS,6,6,0,413163,100%
7344,MLM-LAWN_MOWER_WHEELS,1,1,0,413163,100%
7345,MLB-SWR_AND_POWER_METERS,7,11,0,413163,100%
7346,MLM-VIDEO_GAME_CONTROLLER_CHARGER_PINS,1,1,0,413163,100%
7347,MLB-FLASH_FILTERS,9,37,0,413163,100%
7348,MLB-LIP_PLUMPER_DEVICES,5,6,0,413163,100%
7349,MLB-SABELS,4,3,0,413163,100%
7350,MLB-DOG_BACKPACKS_AND_SADDLEBAGS,6,13,0,413163,100%
7352,MLB-PORTABLE_GAME_CONSOLE_REPLACEMENT_SCREENS,12,11,0,413163,100%
7353,MLB-EROTIC_BABYDOLLS,5,11,0,413163,100%
7354,MLM-COMMERCIAL_STACKABLE_CRATES,1,1,0,413163,100%
7355,MLM-BACK_GLASS_WIPER_ARMS,1,0,0,413163,100%
7356,MLB-STOCK_TANK_POOLS,8,17,0,413163,100%
7357,MLB-WORKBENCHES,15,33,0,413163,100%
7358,MLB-ELECTRIC_SHEARS,15,18,0,413163,100%
7359,MLB-AUTOMOTIVE_FREEZE_PLUGS,16,17,0,413163,100%
7360,MLB-SQUEEZERS,13,13,0,413163,100%
7361,MLB-POOL_HANDRAILS,3,2,0,413163,100%
7363,MLB-SHAWARMA_MACHINES,10,6,0,413163,100%
7364,MLB-GAS_POLE_SAWS,2,2,0,413163,100%
7365,MLB-BABY_BOTTLE_TOTE_BAGS,3,31,0,413163,100%
7366,MLB-BDSM_GAGS,15,3,0,413163,100%
7367,MLB-CLIMBING_SHOES,7,11,0,413163,100%
7368,MLB-NAIL_POLISH_THINNERS,7,10,0,413163,100%
7369,MLB-EASTER_EGGS,8,6,0,413163,100%
7370,MLB-PHOTOGRAPHIC_EQUIPMENT_SUITCASES,11,12,0,413163,100%
7371,MLB-QUEUE_STANCHIONS,4,1,0,413163,100%
7372,MLB-DRUM_HOOPS,5,5,0,413163,100%
7373,MLM-GLASS_SAFETY_FILMS,1,0,0,413163,100%
7374,MLM-ALL_TERRAIN_VEHICLE_DRIVE_BELTS,1,4,0,413163,100%
7375,MLB-TILE_CUTTER_SCORING_WHEELS,11,20,0,413163,100%
7377,MLB-ROCK_CRUSHERS,6,1,0,413163,100%
7378,MLB-VEHICLE_TRAILER_LIGHT_POWER_MODULES,9,20,0,413163,100%
7379,MLB-OATMEAL,9,7,0,413163,100%
7380,MLB-FIBER_OPTIC_FAULT_LOCATORS,3,2,0,413163,100%
7381,MLM-INDUSTRIAL_COFFEE_ROASTERS,1,1,0,413163,100%
7382,MLB-SHOWER_CURTAIN_HOOKS,14,29,0,413163,100%
7383,MLB-INDUSTRIAL_LIQUID_CHILLERS,6,13,0,413163,100%
7385,MLB-MATE_GOURDS,12,10,0,413163,100%
7386,MLB-MACARONS,6,18,0,413163,100%
7387,MLB-DENTAL_PLIERS,18,16,0,413163,100%
7388,MLM-DOG_POOP_BAG_DISPENSERS,1,1,0,413163,100%
7389,MLB-TUTUS,33,95,0,413163,100%
7390,MLB-DEVELOPMENT_LANDS_FOR_SALE,2,2,0,413163,100%
7391,MLB-DECORATIVE_COLUMNS,16,16,0,413163,100%
7392,MLB-STRING_INSTRUMENT_MUTES,8,9,0,413163,100%
7393,MLB-GOLF_GLOVES,8,6,0,413163,100%
7394,MLB-FLOOR_CRANES,21,34,0,413163,100%
7395,MLB-PROJECTOR_MOTHERBOARDS,3,2,0,413163,100%
7396,MLB-3D_PRINTER_NOZZLES,6,6,0,413163,100%
7397,MLB-AIR_HOCKEY_TABLES,16,32,0,413163,100%
7398,MLM-REHABILITATION_GYROSCOPE_BALLS,1,1,0,413163,100%
7399,MLB-SPEED_RINGS,3,10,0,413163,100%
7400,MLB-SPARKLING_CIDERS,6,9,0,413163,100%
7401,MLB-FIRE_HOSES,10,7,0,413163,100%
7402,MLB-AIR_CONDITIONER_BLOWER_WHEELS,2,3,0,413163,100%
7403,MLB-GRASS_PAVERS,5,11,0,413163,100%
7404,MLB-SELF_CONTAINED_BREATHING_APPARATUS,15,29,0,413163,100%
7405,MLB-GOLF_CLUBS_PUTTERS,4,12,0,413163,100%
7406,MLB-ANTIQUE_LOCKETS,6,8,0,413163,100%
7407,MLB-GOLF_CLUBS_WOODS_AND_HYBRIDS,2,1,0,413163,100%
7408,MLB-FISH_TANK_NETS,3,5,0,413163,100%
7409,MLB-TIRE_SNOW_CHAINS,7,7,0,413163,100%
7410,MLB-VACUUM_CLEANER_BAGS,6,6,0,413163,100%
7411,MLB-DISTILLERS,1,1,0,413163,100%
7412,MLM-FLASH_FILTERS,1,1,0,413163,100%
7413,MLB-FIBER_OPTIC_CLEANERS,5,5,0,413163,100%
7414,MLB-CHARCOAL,11,17,0,413163,100%
7415,MLB-CONTROL_VINYLS,1,1,0,413163,100%
7416,MLB-MOTORCYCLE_SPOKE_COVERS,16,50,0,413163,100%
7417,MLB-GOLF_TEES,1,1,0,413163,100%
7418,MLB-INDOOR_GROWING_LIGHTS,10,15,0,413163,100%
7419,MLB-SURFBOARD_RACKS,14,16,0,413163,100%
7420,MLB-CONSTRUCTION_SAND,3,2,0,413163,100%
7421,MLB-AUTOMOTIVE_CRASH_GUARDS,28,30,0,413163,100%
7422,MLB-INFLATABLE_SLIDES,27,24,0,413163,100%
7423,MLB-PET_RAINCOATS,10,9,0,413163,100%
7424,MLB-NESTING_DOLLS,7,8,0,413163,100%
7425,MLB-SKIN_PUMICE_STONES,7,13,0,413163,100%
7426,MLB-SOLAR_POOL_IONIZERS,2,6,0,413163,100%
7427,MLB-FIELD_HOCKEY_STICKS,2,0,0,413163,100%
7428,MLB-FISH_TANK_CHILLERS,14,6,0,413163,100%
7429,MLB-VIDEO_GAME_CONTROLLER_CHARGER_PINS,14,23,0,413163,100%
7430,MLB-WINTER_EARMUFFS,9,10,0,413163,100%
7431,MLB-PET_FOOD_STORAGE_CONTAINERS,8,9,0,413163,100%
7432,MLB-PAINTBALL_SMOKE_GRENADES,6,18,0,413163,100%
7433,MLM-GOLF_CLUBS_PUTTERS,1,0,0,413163,100%
7434,MLM-CAMERA_PHOTOMETERS,1,0,0,413163,100%
7435,MLB-PEC_DECK_MACHINES,10,14,0,413163,100%
7436,MLB-LABORATORY_PIPETTES,2,1,0,413163,100%
7437,MLB-DIE_STOCKS,8,6,0,413163,100%
7438,MLB-SAFETY_TRIANGLES,25,36,0,413163,100%
7440,MLB-BASKETBALL_NETS,8,13,0,413163,100%
7441,MLB-INDUSTRIAL_BOILERS,12,11,0,413163,100%
7442,MLB-AUTOMOTIVE_AC_COMPRESSOR_BRACKETS,3,3,0,413163,100%
7443,MLB-RUGBY_SHOES,6,7,0,413163,100%
7444,MLB-BATH_AND_SAUNA_STEAM_GENERATORS,13,16,0,413163,100%
7445,MLM-USB_PADLOCKS,1,2,0,413163,100%
7446,MLM-DENTAL_CHAIRS,1,2,0,413163,100%
7447,MLB-BILL_BOOKS,7,9,0,413163,100%
7448,MLM-DOOR_HANDLES,1,1,0,413163,100%
7449,MLB-DENTAL_PORCELAIN_OVENS,2,1,0,413163,100%
7450,MLB-DIGESTIVE_MEDICINES,2,12,0,413163,100%
7451,MLM-PDA_CASES_AND_BAGS,1,1,0,413163,100%
7452,MLB-BILL_ACCEPTORS,6,14,0,413163,100%
7453,MLM-TELEPHONE_BOOTHS,1,1,0,413163,100%
7454,MLM-DULCE_DE_LECHE,1,0,0,413163,100%
7455,MLB-SINGING_BOWLS,8,13,0,413163,100%
7456,MLB-INDUSTRIAL_POWDER_AND_LIQUID_MIXER_MACHINES,2,0,0,413163,100%
7457,MLB-CALL_BLOCKERS,14,16,0,413163,100%
7458,MLB-CANDLE_WICKS,8,13,0,413163,100%
7459,MLB-ERGONOMIC_ARMRESTS,11,12,0,413163,100%
7460,MLB-INDUSTRIAL_ATOMIZER_MILLS,5,4,0,413163,100%
7461,MLB-LAPTOP_INVERTERS,5,4,0,413163,100%
7462,MLB-BUTTON_FOOTBALL_TABLES,10,7,0,413163,100%
7463,MLB-CONNECTING_COUPLERS,18,22,0,413163,100%
7464,MLB-PERCUSSION_WASHERS,3,3,0,413163,100%
7465,MLB-EDIBLE_MARKERS,3,4,0,413163,100%
7466,MLB-CHECK_HOLDERS,3,5,0,413163,100%
7467,MLB-FRY_DUMP_STATIONS,1,0,0,413163,100%
7468,MLB-JEWELRY_DISPLAYS_AND_BOXES,23,23,0,413163,100%
7469,MLB-WINE_AERATORS,6,7,0,413163,100%
7470,MLB-SUGAR,5,2,0,413163,100%
7471,MLB-MASONRY_TROWELS,17,6,0,413163,100%
7472,MLB-PACKAGING_STRAPPINGS,8,7,0,413163,100%
7473,MLB-GROCERY_BAG_HANDLES,2,1,0,413163,100%
7474,MLB-VEGETABLES_AND_FRUITS,2,0,0,413163,100%
7475,MLB-CLEANING_TROLLEYS,11,23,0,413163,100%
7476,MLB-COMMERCIAL_NO_LIGHT_SIGNS,6,3,0,413163,100%
7477,MLB-CAMERA_PHOTOMETERS,5,5,0,413163,100%
7478,MLB-CHASTITY_BELTS_AND_CAGES,10,21,0,413163,100%
7479,MLB-INHALER_SPACERS,7,3,0,413163,100%
7480,MLB-DUSTERS,3,4,0,413163,100%
7481,MLB-PROXIMITY_KEY_FOBS,5,9,0,413163,100%
7482,MLB-SNOWBOARDS,4,5,0,413163,100%
7484,MLB-ELECTRODE_HOLDERS,6,6,0,413163,100%
7485,MLB-MODEL_AIRCRAFT_WHEELS,6,11,0,413163,100%
7486,MLB-KIDS_TOILET_ADAPTER_SEATS,1,0,0,413163,100%
7487,MLB-INDUSTRIAL_WEAVING_MACHINES,3,2,0,413163,100%
7488,MLB-THEATER_TICKETS,3,5,0,413163,100%
7489,MLB-BEAKERS,5,3,0,413163,100%
7490,MLB-MUSICAL_KEYBOARD_RUBBER_CONTACTS,5,2,0,413163,100%
7491,MLB-OPHTHALMOSCOPES,1,2,0,413163,100%
7492,MLB-DONUT_MAKERS,12,18,0,413163,100%
7493,MLB-CIGAR_CUTTERS,10,5,0,413163,100%
7494,MLB-DUSTPANS,2,2,0,413163,100%
7495,MLB-AUDIO_AND_VIDEO_OPTICAL_LASER_LENSES,15,16,0,413163,100%
7496,MLB-MAGNETIC_CARD_READERS,2,0,0,413163,100%
7498,MLB-MUSICAL_TRIANGLES,8,5,0,413163,100%
7499,MLM-BDSM_GAGS,1,1,0,413163,100%
7500,MLB-STRING_TRIMMER_HEADS,11,10,0,413163,100%
7501,MLB-TONIC_WATERS,7,7,0,413163,100%
7502,MLB-OPTOCOUPLERS,4,3,0,413163,100%
7503,MLB-FOLDER_DIVIDERS,10,11,0,413163,100%
7504,MLB-FISHING_ROD_HOLDERS,8,11,0,413163,100%
7505,MLB-BARBELL_PADS,7,13,0,413163,100%
7506,MLB-KEY_CABINETS,7,3,0,413163,100%
7507,MLB-WAKEBOARDS,17,23,0,413163,100%
7508,MLB-CD_AND_DVD_STORAGE_FURNITURE,4,4,0,413163,100%
7509,MLB-NAUTICAL_THROTTLE_LEVERS,3,2,0,413163,100%
7510,MLB-TOY_TOASTERS,3,1,0,413163,100%
7512,MLB-VEHICLE_WHEEL_BALANCERS,9,10,0,413163,100%
7513,MLB-ENGINE_COOLING_FAN_SWITCHES,11,23,0,413163,100%
7514,MLB-FOOD_FILM_WRAPPERS,17,25,0,413163,100%
7515,MLB-MOTORCYCLE_CLUTCH_PRESSURE_PLATES,9,4,0,413163,100%
7516,MLM-CHEMICAL_DRAIN_CLEANERS,1,1,0,413163,100%
7517,MLB-INDUSTRIAL_PUNCHING_MACHINES,2,0,0,413163,100%
7519,MLB-RELIGIOUS_RETABLOS,10,6,0,413163,100%
7520,MLB-INKWELLS,2,1,0,413163,100%
7522,MLB-EROTIC_DRESSES,5,2,0,413163,100%
7523,MLM-BUTTER,1,1,0,413163,100%
7524,MLB-BILLIARD_CUE_FERRULES,9,9,0,413163,100%
7525,MLB-WORK_JACKETS,4,2,0,413163,100%
7526,MLB-EROTIC_CORSETS,7,16,0,413163,100%
7527,MLB-BUTTON_FOOTBALL_GOALS,9,14,0,413163,100%
7528,MLB-CLIMBING_ASCENDERS,3,5,0,413163,100%
7529,MLB-ACCESS_TURNSTILES,4,11,0,413163,100%
7530,MLB-CANOES,8,8,0,413163,100%
7531,MLB-MEDICAL_ULTRASOUND_SCANNERS,21,33,0,413163,100%
7532,MLB-KITCHEN_CHEESE_SLICERS,13,11,0,413163,100%
7533,MLB-PERSONAL_DIGITAL_ASSISTANT_SOFTWARE,1,0,0,413163,100%
7534,MLM-REMOTE_CONTROL_HOLDERS,1,1,0,413163,100%
7535,MLB-PASTRY_BRUSHES,7,4,0,413163,100%
7536,MLB-FENCE_PRIVACY_TAPES,2,2,0,413163,100%
7537,MLB-DRUM_KEYS,11,12,0,413163,100%
7538,MLB-CHEMICAL_DRAIN_CLEANERS,4,4,0,413163,100%
7539,MLB-MANUAL_DOUGH_DIVIDERS,4,1,0,413163,100%
7540,MLB-CARDBOARD_CUTTING_MACHINES,1,0,0,413163,100%
7541,MLB-AUTOMOTIVE_STEREO_CAGES,4,5,0,413163,100%
7542,MLB-BEETLES,9,28,0,413163,100%
7543,MLB-WATCH_REPAIR_TOOL_KITS,1,0,0,413163,100%
7544,MLB-LAPTOP_BGA_STENCILS,16,18,0,413163,100%
7545,MLB-BICYCLE_SPOKE_NIPPLES,2,3,0,413163,100%
7546,MLB-AUTOMOTIVE_OBD_CONNECTORS,8,7,0,413163,100%
7547,MLB-BAKERY_MOULDERS,8,8,0,413163,100%
7549,MLB-BOARD_AND_BATTEN_SHUTTERS,1,3,0,413163,100%
7551,MLM-BEACH_BALLS,2,0,0,413163,100%
7552,MLB-BABY_BASSINETS_AND_MOSES_BASKETS,3,9,0,413163,100%
7553,MLB-MARTIAL_ARTS_FOOT_GUARDS,3,2,0,413163,100%
7554,MLB-NAUTICAL_STEERING_WHEELS,2,2,0,413163,100%
7555,MLB-MINING_RIGS,12,16,0,413163,100%
7556,MLM-GAME_CONSOLE_POWER_RESET_BOARDS,1,0,0,413163,100%
7557,MLB-MULTIFUNCTIONAL_PLIERS,7,11,0,413163,100%
7558,MLB-BROOMS,19,31,0,413163,100%
7559,MLB-AUTOMOTIVE_FUEL_FILLER_DOOR_RELEASE_CABLES,16,10,0,413163,100%
7560,MLB-FREE_FLIGHT_HELMETS,7,7,0,413163,100%
7562,MLM-CRYPTOCURRENCY_HARDWARE_WALLETS,1,2,0,413163,100%
7563,MLB-DIVING_GLOVES,5,5,0,413163,100%
7564,MLB-GOLF_CLUBS_SETS,12,23,0,413163,100%
7565,MLB-CONSTRUCTION_STILTS,2,2,0,413163,100%
7566,MLB-PISCOS,1,1,0,413163,100%
7567,MLB-CO2_LASER_TUBES,6,4,0,413163,100%
7568,MLB-AUTOMOTIVE_POWER_STEERING_OIL_PRESSURE_SENSORS,1,1,0,413163,100%
7569,MLB-WASHING_MACHINE_GEARBOXES,8,9,0,413163,100%
7570,MLM-AUTOMATIC_PET_BALL_LAUNCHERS,1,0,0,413163,100%
7571,MLB-OUTBOARD_MOTOR_GEARS,10,8,0,413163,100%
7572,MLB-POOL_PAINTS,6,6,0,413163,100%
7573,MLB-AUTOMATIC_BARRIERS,4,5,0,413163,100%
7574,MLB-HARVESTERS,10,14,0,413163,100%
7575,MLB-ANTI_STATIC_GLOVES,3,2,0,413163,100%
7577,MLM-COMPUTER_AND_GAME_CONSOLE_COOLER_AND_FAN_GRILLS,1,0,0,413163,100%
7578,MLM-AUTOMOTIVE_BRAKE_FORCE_REGULATORS,1,1,0,413163,100%
7579,MLB-CO2_EFFECTS_MACHINES,4,3,0,413163,100%
7580,MLB-GAME_CONSOLE_MULTITAPS,8,13,0,413163,100%
7581,MLB-NAIL_SAMPLES,9,13,0,413163,100%
7582,MLB-PRINTER_BEARINGS,2,2,0,413163,100%
7583,MLB-REFRIGERATOR_AND_FREEZER_LIGHT_SWITCHES,6,6,0,413163,100%
7584,MLB-ANALOG_RAIN_GAUGES,5,5,0,413163,100%
7585,MLB-CANDLE_WAXES,8,15,0,413163,100%
7586,MLB-TILE_AND_CLADDING_ADHESIVE_MIXTURES,3,1,0,413163,100%
7587,MLB-EROTIC_VAGINAL_DILATORS,1,2,0,413163,100%
7588,MLB-HIKING_SPORT_HELMETS,8,7,0,413163,100%
7589,MLB-FRANKLIN_STOVES,1,17,0,413163,100%
7590,MLB-USB_WARMERS,7,3,0,413163,100%
7591,MLB-ARCADE_MACHINE_COIN_DOORS,7,5,0,413163,100%
7592,MLB-NON_SLIP_BATHTUB_APPLIQUES_AND_MATS,5,4,0,413163,100%
7593,MLB-FISHING_GRIPPERS,4,4,0,413163,100%
7594,MLB-AUTOMOTIVE_REVERSE_LIGHT_SWITCHES,10,12,0,413163,100%
7595,MLB-GAME_CONSOLE_REPLACEMENT_MOTORS,5,7,0,413163,100%
7596,MLB-BAKING_POWDERS,2,2,0,413163,100%
7597,MLB-NAIL_TAPES,10,17,0,413163,100%
7598,MLB-BICYCLE_CHAIN_GUARDS,10,12,0,413163,100%
7599,MLB-SCHOOL_CHALKS,4,1,0,413163,100%
7600,MLB-FAKE_BANGS,27,34,0,413163,100%
7601,MLB-HYDROCHLORIC_ACID,4,6,0,413163,100%
7602,MLB-EROTIC_BODYSUITS_AND_CATSUITS,14,13,0,413163,100%
7603,MLB-COOKING_YEASTS,6,6,0,413163,100%
7604,MLB-PINATAS,2,1,0,413163,100%
7605,MLB-BICYCLE_TRAINING_WHEELS,5,6,0,413163,100%
7606,MLB-FIRE_HOSE_CABINETS,3,2,0,413163,100%
7607,MLM-PERCUSSION_WASHERS,1,1,0,413163,100%
7608,MLB-HARPS,5,6,0,413163,100%
7609,MLB-CROSSBREED_DOGS,3,3,0,413163,100%
7610,MLB-SURGICAL_LIGHTS,5,3,0,413163,100%
7611,MLB-BDSM_BLINDFOLDS,5,10,0,413163,100%
7612,MLB-TAMPING_RAMMERS,7,8,0,413163,100%
7613,MLB-ICE_SKATES,5,6,0,413163,100%
7614,MLB-HOSE_HOLDERS,10,11,0,413163,100%
7615,MLB-KITCHEN_WHISKS,21,38,0,413163,100%
7616,MLB-BARBELL_COLLARS,7,10,0,413163,100%
7617,MLB-RABBIT_AND_RODENT_HOUSES,11,21,0,413163,100%
7618,MLB-ELECTRONIC_AND_ELECTRICAL_COMPONENT_LUBRICANTS,5,12,0,413163,100%
7620,MLB-EDM_MACHINES,8,9,0,413163,100%
7621,MLB-EROTIC_EDIBLE_BODY_PAINTS,5,4,0,413163,100%
7622,MLB-COFFEE_CREAMERS,3,3,0,413163,100%
7623,MLB-MOTORCYCLE_BENDIX_STARTERS,8,14,0,413163,100%
7624,MLB-LAPTOP_LOCKS,4,2,0,413163,100%
7626,MLB-CHINCHILLAS,13,31,0,413163,100%
7627,MLB-VIDEO_CAMERA_CASES_AND_BAGS,3,9,0,413163,100%
7628,MLB-CORK_SHEETS_AND_ROLLS,1,1,0,413163,100%
7629,MLB-BABY_TOWELS,8,6,0,413163,100%
7630,MLB-ELECTRIC_FIREPLACES,5,10,0,413163,100%
7631,MLB-SWIMMING_NOSE_CLIPS,2,3,0,413163,100%
7632,MLB-TOOL_CARTS,3,4,0,413163,100%
7634,MLB-BACK_SCRATCHERS,7,9,0,413163,100%
7635,MLB-NAUTICAL_LADDERS,6,10,0,413163,100%
7637,MLB-BABY_BISCUITS,6,3,0,413163,100%
7638,MLB-HYDRAULIC_POWER_UNITS,11,7,0,413163,100%
7639,MLB-EROTIC_SOCKS_AND_PANTYHOSES,2,1,0,413163,100%
7640,MLB-NON_STICK_COOKING_SPRAYS,7,7,0,413163,100%
7641,MLB-MEDICAL_HOSES,1,2,0,413163,100%
7643,MLB-WAFFLE_MAKERS,1,0,0,413163,100%
7644,MLB-BILLIARD_TABLE_CLOTHS,11,32,0,413163,100%
7645,MLM-HARDWARE_NUTS,1,1,0,413163,100%
7646,MLB-CLIMBING_PULLEYS,3,0,0,413163,100%
7647,MLB-TABLE_BRAZIERS,3,2,0,413163,100%
7648,MLB-WAKEBOARD_BOOTS,2,5,0,413163,100%
7649,MLB-CAR_DIFFERENTIAL_COVERS,7,6,0,413163,100%
7650,MLB-RHINESTONE_ROLLS,12,6,0,413163,100%
7651,MLB-ARDUINO_MICROCONTROLLERS,1,1,0,413163,100%
7652,MLB-ALUMINUM_FOILS,9,12,0,413163,100%
7653,MLB-CHOPSTICKS,8,10,0,413163,100%
7654,MLB-SUNBEDS,14,20,0,413163,100%
7655,MLB-INDUSTRIAL_COFFEE_ROASTERS,5,3,0,413163,100%
7656,MLB-CABLE_COVERS,1,1,0,413163,100%
7657,MLB-IAT_SENSORS,4,9,0,413163,100%
7658,MLM-DIESEL_VACUUM_PUMPS,1,0,0,413163,100%
7659,MLB-TRANSPARENCY_PROJECTORS,5,5,0,413163,100%
7660,MLB-TACTICAL_JACKETS,8,6,0,413163,100%
7661,MLB-ETHYL_ALCOHOL,2,5,0,413163,100%
7662,MLB-SMOKER_OVENS,10,7,0,413163,100%
7663,MLB-SONG_BOOKS,1,2,0,413163,100%
7664,MLM-TELEPHONE_BILLING_METERS,1,2,0,413163,100%
7665,MLB-EROTIC_PERFUMES,4,7,0,413163,100%
7666,MLB-MILKING_MACHINES,8,12,0,413163,100%
7667,MLB-EROTIC_GLOVES_AND_MITTENS,2,1,0,413163,100%
7668,MLB-BABY_OILS,3,2,0,413163,100%
7669,MLB-EROTIC_CHAIRS_AND_SOFAS,3,5,0,413163,100%
7670,MLB-GREENHOUSES,3,5,0,413163,100%
7671,MLB-DICE,1,0,0,413163,100%
7672,MLB-WALKIE_TALKIE_COVERS,4,4,0,413163,100%
7673,MLB-BRUSH_CUTTER_FUEL_TANKS,5,2,0,413163,100%
7674,MLB-DRILLING_RIGS,1,1,0,413163,100%
7675,MLB-LAWN_EDGINGS,12,12,0,413163,100%
7676,MLB-BILLIARD_CHALKS,3,6,0,413163,100%
7677,MLB-DENTAL_CURETTES,7,3,0,413163,100%
7678,MLM-PACKAGING_STRAPPINGS,1,0,0,413163,100%
7680,MLB-INDUSTRIAL_DISHWASHERS,3,2,0,413163,100%
7681,MLB-STICKY_NOTES,16,12,0,413163,100%
7682,MLB-COGNACS,8,3,0,413163,100%
7683,MLB-HAND_AND_FOOT_MASKS,4,4,0,413163,100%
7684,MLB-PROXIMITY_READERS,6,4,0,413163,100%
7685,MLB-KITCHEN_CORERS_AND_PITTERS,2,2,0,413163,100%
7686,MLB-SHOE_BRUSHES,5,7,0,413163,100%
7687,MLB-MINI_LIVESTOCK_FEED_PLANTS,8,18,0,413163,100%
7688,MLB-MOTORCYCLE_GOGGLE_TEAR_OFFS,2,5,0,413163,100%
7689,MLB-ANTI_FATIGUE_MATS,1,1,0,413163,100%
7690,MLB-NAUTICAL_SEATS,2,2,0,413163,100%
7691,MLB-TENNIS_AND_SQUASH_RACKET_VIBRATION_DAMPENERS,6,0,0,413163,100%
7692,MLB-EYE_CARE_MEDICINES,3,1,0,413163,100%
7693,MLB-WIRE_ROPE_CLIPS,2,2,0,413163,100%
7694,MLB-PARTY_FAVOR_RINGS,1,0,0,413163,100%
7695,MLB-EMPANADAS,4,6,0,413163,100%
7696,MLB-LAPTOP_REPLACEMENT_INTERNAL_WEBCAMS,5,3,0,413163,100%
7697,MLB-MAGNETIC_TRAYS,3,2,0,413163,100%
7698,MLB-DISTILLATION_FLASKS,1,0,0,413163,100%
7699,MLB-PLANT_MARKERS,2,0,0,413163,100%
7700,MLB-STAIRS_AND_BALCONIES_RAILS,5,12,0,413163,100%
7701,MLB-AUTOMOTIVE_TOW_STRAPS,1,0,0,413163,100%
7702,MLB-TOOL_ELECTRIC_SHARPENERS,3,4,0,413163,100%
7703,MLB-AUTOMOTIVE_ENGINE_TIMING_COVERS,2,1,0,413163,100%
7704,MLB-SHUT_OFF_VALVES,15,28,0,413163,100%
7705,MLB-ELECTRIC_MEAT_MIXERS,3,9,0,413163,100%
7706,MLB-REUSABLE_MASKS,1,2,0,413163,100%
7707,MLB-MOTORCYCLE_HANDLEBAR_PADS,9,14,0,413163,100%
7708,MLB-TAG_PINS,2,2,0,413163,100%
7709,MLB-CLIMBING_SLINGS,1,1,0,413163,100%
7710,MLB-REVERSE_OSMOSIS_FILTERS,4,6,0,413163,100%
7711,MLB-WATER_TANK_LIDS,2,2,0,413163,100%
7712,MLB-RISER_CARDS,2,2,0,413163,100%
7713,MLB-AUTOMOTIVE_ENGINE_COOLANT_THERMOSTAT_HOUSINGS,2,3,0,413163,100%
7714,MLB-SWIMMING_GLOVES_AND_PADDLES,6,8,0,413163,100%
7715,MLB-SWIM_CAPS,33,41,0,413163,100%
7716,MLB-KITCHEN_NUTCRACKERS,1,1,0,413163,100%
7717,MLB-EROTIC_WOMEN_SWIMWEAR,3,1,0,413163,100%
7718,MLB-NAUTICAL_FENDERS,2,2,0,413163,100%
7719,MLB-DIGITAL_PORTABLE_MEDIA_PLAYER_BATTERIES,5,5,0,413163,100%
7720,MLB-AUTOMATIC_PAD_PRINTING_MACHINES,1,1,0,413163,100%
7721,MLB-COLD_FOOD_AND_DRINK_VENDING_MACHINES,5,8,0,413163,100%
7722,MLB-DIDGERIDOOS,2,3,0,413163,100%
7723,MLB-SCHEDULED_SERVICES,3,8,0,413163,100%
7724,MLB-VEHICLE_TRAILER_CONNECTORS,3,6,0,413163,100%
7725,MLB-INDUSTRIAL_BREAD_SLICERS,1,2,0,413163,100%
7726,MLB-PHEROMONE_CONCENTRATES,2,13,0,413163,100%
7727,MLB-OPTICAL_LEVELS,5,3,0,413163,100%
7728,MLB-ELECTRIC_GRAIN_MILLS,3,4,0,413163,100%
7729,MLB-WOOD_PROTECTIVE_PAINTS,6,13,0,413163,100%
7730,MLB-FIREPLACE_TOOL_SETS,2,2,0,413163,100%
7731,MLB-NAUTICAL_INSPECTION_HATCHES,4,4,0,413163,100%
7732,MLB-MANUAL_TROLLEYS,3,4,0,413163,100%
7733,MLB-LABEL_MAKER_INK_ROLLERS,2,2,0,413163,100%
7734,MLB-BICYCLE_SPRING_SUSPENSIONS,2,2,0,413163,100%
7735,MLB-VEGETABLE_AND_FRUIT_SORTING_MACHINES,10,12,0,413163,100%
7736,MLB-SAVORY_AND_SWEET_MACHINES,4,6,0,413163,100%
7737,MLB-CAR_FRONT_BUMPERS,1,0,0,413163,100%
7738,MLB-HYDROMETERS,7,3,0,413163,100%
7739,MLB-LENS_EXTENSION_TUBES,7,16,0,413163,100%
7740,MLB-KAYAK_SEATS,3,2,0,413163,100%
7741,MLB-PROJECTOR_CHIPS,2,2,0,413163,100%
7742,MLB-SQUISHIES,4,4,0,413163,100%
7743,MLB-BABY_BOTTLE_DRYING_RACKS,8,9,0,413163,100%
7744,MLB-AUTOMATIC_PET_BALL_LAUNCHERS,1,1,0,413163,100%
7745,MLB-HYDROPONIC_FOAMS,3,4,0,413163,100%
7746,MLB-TATTOO_FOOT_PEDALS,2,2,0,413163,100%
7747,MLB-DANCE_METATARSAL_PROTECTORS,6,1,0,413163,100%
7748,MLB-3D_PRINTER_THERMISTORS,2,3,0,413163,100%
7749,MLB-BEARING_BALLS,2,2,0,413163,100%
7750,MLB-DATA_TAPES,3,3,0,413163,100%
7751,MLB-MANUAL_DOUGH_SHEETERS,3,9,0,413163,100%
7752,MLB-BASEBALL_AND_SOFTBALL_FIELDING_GLOVES,1,0,0,413163,100%
7753,MLB-POWDER_COATING_OVENS,3,6,0,413163,100%
7754,MLB-INDUSTRIAL_MORTISING_MACHINES,2,0,0,413163,100%
7755,MLB-WATER_SOFTENERS,3,5,0,413163,100%
7756,MLB-ZAFUS,6,2,0,413163,100%
7757,MLB-GRAIN_DRYERS,3,2,0,413163,100%
7758,MLB-OXYGEN_PRESSURE_REGULATORS,3,1,0,413163,100%
7759,MLB-BILLIARD_BALL_RACKS,3,1,0,413163,100%
7760,MLB-ALL_TERRAIN_VEHICLE_BOXES,2,2,0,413163,100%
7761,MLB-PACKAGING_CONTAINERS,3,4,0,413163,100%
7762,MLB-COMPUTER_ANTI_STATIC_FOAMING_CLEANERS,2,4,0,413163,100%
7763,MLB-GINGER,2,0,0,413163,100%
7764,MLB-CRIMINALISTIC_KITS,2,4,0,413163,100%
7765,MLB-WIRELESS_MONITOR_SYSTEMS,5,5,0,413163,100%
7766,MLB-EGG_SEPARATORS,4,10,0,413163,100%
7767,MLB-ABSORBENT_SWEAT_PADS,1,1,0,413163,100%
7768,MLB-MAKEUP_BRUSH_LIQUID_CLEANERS,1,0,0,413163,100%
7769,MLB-AUTOMOTIVE_HEATER_HOSES,4,3,0,413163,100%
7770,MLB-DEVELOPMENT_HOUSES_FOR_SALE,1,6,0,413163,100%
7771,MLB-PASTRY_RULERS,1,2,0,413163,100%
7772,MLB-3D_PRINTER_HEATBEDS,5,7,0,413163,100%
7773,MLB-TEST_TUBE_RACKS,2,1,0,413163,100%
7774,MLB-HOUSEHOLD_CLEANING_WAXES,8,10,0,413163,100%
7775,MLB-PET_ROBES,1,1,0,413163,100%
7776,MLB-ELECTRIC_CAN_OPENERS,4,2,0,413163,100%
7777,MLB-MOTORCYCLE_CLUTCH_COVER_GASKETS,8,18,0,413163,100%
7778,MLB-FRUIT_PICKERS,1,0,0,413163,100%
7779,MLB-LAWN_MOWER_HOUSINGS,1,1,0,413163,100%
7780,MLB-TOY_NEODYMIUM_MAGNETS,7,17,0,413163,100%
7781,MLB-SORE_THROAT_MEDICINES,1,1,0,413163,100%
7782,MLB-SPORT_COLLECTIBLES,2,1,0,413163,100%
7783,MLB-COUNTERFLOW_BEER_WORT_CHILLERS,2,3,0,413163,100%
7784,MLB-VEHICLE_ELECTRIC_WINCHES,5,16,0,413163,100%
7785,MLB-CELLPHONE_MOTHERBOARDS,1,1,0,413163,100%
7786,MLB-MOTORCYCLE_BRAKE_MASTER_CYLINDER_RESERVOIRS,2,3,0,413163,100%
7787,MLB-TOILEVATORS,3,1,0,413163,100%
7788,MLB-FLASHLIGHT_POUCHES,3,2,0,413163,100%
7789,MLB-WASTE_SHREDDERS,5,4,0,413163,100%
7790,MLB-OFFICE_STAPLER_STAPLES,4,6,0,413163,100%
7791,MLB-OFFICE_CONFERENCE_TABLES,3,1,0,413163,100%
7792,MLB-SCHOOL_AND_OFFICE_PINS_AND_TACKS,1,3,0,413163,100%
7793,MLB-TACTICAL_HANDCUFF_CASES,1,1,0,413163,100%
7794,MLB-VEHICLE_TRACKERS,1,8,0,413163,100%
7795,MLB-LIQUID_ELECTRICAL_TAPES,2,3,0,413163,100%
7796,MLB-HAIR_DYEING_PAPERS,2,6,0,413163,100%
7797,MLB-TRAINING_HURDLES,1,1,0,413163,100%
7798,MLB-ORTHODONTIC_RETAINER_BOXES,1,2,0,413163,100%
7799,MLB-MUSICAL_COWBELLS,1,0,0,413163,100%
7800,MLB-VIDEO_GAME_CONTROLLERS,1,0,0,413163,100%
7801,MLB-PROJECTOR_CASES_AND_BAGS,2,8,0,413163,100%
7802,MLB-TANK_STANDS,1,1,0,413163,100%
7803,MLB-PROMOTIONAL_PRODUCTS,1,1,0,413163,100%
7804,MLB-TREAT_DISPENSING_PET_TOYS,5,10,0,413163,100%
7805,MLB-WIND_INSTRUMENT_LIGATURES,2,4,0,413163,100%
7806,MLB-STRIP_CUTTING_MACHINES,3,3,0,413163,100%
7807,MLB-QUENAS,2,3,0,413163,100%
7808,MLB-EMERGENCY_THERMAL_BLANKETS,3,1,0,413163,100%
7809,MLB-BICYCLE_PROTECTORS,1,1,0,413163,100%
7810,MLB-TACTICAL_BOOTS,2,6,0,413163,100%
7811,MLB-SKYLIGHTS,3,0,0,413163,100%
7813,MLB-ARCADE_MACHINE_COINS,4,2,0,413163,100%
7814,MLB-DRONE_BODY_SHELLS,3,2,0,413163,100%
7815,MLB-EROTIC_EDIBLE_LINGERIE_SETS,3,3,0,413163,100%
7816,MLB-BICYCLE_TRAILERS,6,12,0,413163,100%
7817,MLB-INDUSTRIAL_DONUT_MAKERS,1,7,0,413163,100%
7818,MLB-FISH_TANK_BASES,1,0,0,413163,100%
7819,MLB-MOTORCYCLE_SPARK_PLUG_CAPS,2,2,0,413163,100%
7820,MLB-MODEL_AIRCRAFT_BLADES,1,1,0,413163,100%
7821,MLB-MATCHSTICKS,1,0,0,413163,100%
7822,MLB-COLLECTIBLE_TOKENS,2,2,0,413163,100%
7823,MLB-SAT_FISCAL,1,1,0,413163,100%
7824,MLB-BRANDIES,1,1,0,413163,100%
7825,MLB-ASPHALT_ROOFING_MEMBRANES,1,1,0,413163,100%
7826,MLB-LOAD_MOVING_SKATES,1,3,0,413163,100%
7827,MLB-AMBULANCE_STRETCHERS,5,6,0,413163,100%
7828,MLB-FLIP_FLOP_STRAP_ATTACHING_MACHINES,2,1,0,413163,100%
7829,MLB-PRECISION_SCALES,6,5,0,413163,100%
7830,MLB-PARQUET_AND_FLOATING_FLOORS_SERVICES,1,2,0,413163,100%
7831,MLB-SEX_MACHINES,1,1,0,413163,100%
7832,MLB-CONVEYOR_BELTS,1,0,0,413163,100%
7833,MLB-MANUAL_PET_BALL_LAUNCHERS,3,2,0,413163,100%
7834,MLB-CLIMBING_DESCENDERS,2,1,0,413163,100%
7835,MLB-REPTILE_AND_AMPHIBIAN_FOODS,1,1,0,413163,100%
7836,MLB-HEAT_TREAT_OVENS,3,6,0,413163,100%
7837,MLB-FOOTWEAR_LASTS,1,4,0,413163,100%
7838,MLB-INDUSTRIAL_GRATERS,1,2,0,413163,100%
7839,MLB-GAME_CONSOLE_CAMERA_MOUNTS,2,3,0,413163,100%
7840,MLB-BROOM_AND_SQUEEGEE_HANDLES,2,3,0,413163,100%
7841,MLB-RODENT_SHAMPOOS,1,0,0,413163,100%
7842,MLB-EROTIC_NIPPLE_COVERS,1,1,0,413163,100%
7843,MLB-ACTION_CAMERA_ANTI_FOG_INSERTS,1,1,0,413163,100%
7844,MLB-COMPUTER_AND_GAME_CONSOLE_COOLER_AND_FAN_GRILLS,3,3,0,413163,100%
7845,MLB-SKIS,2,2,0,413163,100%
7846,MLB-FURNITURE_TRACKS,2,2,0,413163,100%
7847,MLB-CATUABAS,1,1,0,413163,100%
7848,MLB-PORTABLE_SMOKING_GUNS,1,1,0,413163,100%
7849,MLB-WELDING_CHIPPING_HAMMERS,1,1,0,413163,100%
7850,MLB-FINGERTIP_MOISTENERS,1,0,0,413163,100%
7851,MLB-DARKROOM_ENLARGERS,2,2,0,413163,100%
7852,MLB-SEX_TOY_CLEANERS,1,4,0,413163,100%
7853,MLB-DJ_TURNTABLE_SLIPMATS,1,2,0,413163,100%
7854,MLB-AIR_DUCT_HEATERS,2,3,0,413163,100%
7855,MLB-FABRIC_FRAGRANCES,1,4,0,413163,100%
7856,MLB-PROJECTOR_OPTICAL_BLOCKS,1,1,0,413163,100%
7857,MLB-DIESEL_VACUUM_PUMPS,2,2,0,413163,100%
7858,MLB-LAPTOP_SWITCHES,1,0,0,413163,100%
7859,MLB-MANUAL_CREAM_SEPARATORS,1,0,0,413163,100%
7860,MLB-COCONUT_WATERS,1,0,0,413163,100%
7861,MLB-CRICKETS,2,4,0,413163,100%
7862,MLB-HYDROPONIC_GROWING_SYSTEMS,1,1,0,413163,100%
7863,MLB-HARD_TAGS,1,1,0,413163,100%
7864,MLB-USB_PADLOCKS,2,3,0,413163,100%
7865,MLB-MOTORCYCLE_GOGGLE_REPLACEMENT_LENSES,1,0,0,413163,100%
7866,MLB-AUTOMOTIVE_TOW_HOOKS,1,0,0,413163,100%
7867,MLB-TEXTILE_CLEANING_GUNS,1,1,0,413163,100%
7868,MLB-MILITARY_EPAULETTES,1,1,0,413163,100%
7869,MLB-TATTOO_MACHINE_COILS,1,1,0,413163,100%
7870,MLB-PDA_KEYBOARDS,1,1,0,413163,100%
7871,MLB-KITCHEN_SPREADERS,1,1,0,413163,100%
7872,MLB-SUBSOILERS,1,0,0,413163,100%
7873,MLB-DIGITAL_RAIN_GAUGES,1,1,0,413163,100%
7874,MLB-HONEY_SPOONS,1,1,0,413163,100%
7875,MLB-CONSTRUCTION_MIXING_TUBS,2,4,0,413163,100%
7876,MLB-FISHING_BOOTS,1,1,0,413163,100%
7877,MLB-MANICURE_FINGER_COVER_MOLDS,1,4,0,413163,100%
7878,MLB-PH_METER_BUFFER_SOLUTIONS,1,2,0,413163,100%
7879,MLB-SMOKE_SAFETY_FLARES,2,1,0,413163,100%
7880,MLB-COMBUSTION_HEATERS,1,1,0,413163,100%
7881,MLB-WIRE_ROPE_THIMBLES,1,1,0,413163,100%
7882,MLB-KNIFE_SHEATHS,1,0,0,413163,100%
7883,MLB-VIRTUAL_CURRENCIES,1,0,0,413163,100%
7884,MLB-SKATE_BOOT_COVERS,1,1,0,413163,100%
7885,MLB-ADVERTISING_INFLATABLES,1,0,0,413163,100%
7886,MLB-PRESSURE_TANKS,2,1,0,413163,100%
7887,MLB-PRINTER_CLEANING_KITS,1,0,0,413163,100%
7888,MLB-ELECTRIC_CREAM_SEPARATORS,1,0,0,413163,100%
7889,MLB-BURETTES,1,1,0,413163,100%
7890,MLB-GLASS_SAFETY_FILMS,1,1,0,413163,100%
7891,MLB-SCREEN_PRINTING_KITS,1,4,0,413163,100%
7892,MLB-ANTIQUE_AUDIO_ANTENNAS,1,6,0,413163,100%
7893,MLB-RUGBY_HELMETS,1,5,0,413163,100%
